Group 1:
	Quincy Monger - Email: qmongerc0@imgur.com, Section 9, Major(s): Statistics , Minor(s): Philiosophy 
	Harp Botha - Email: hbotha6p@deliciousdays.com, Section 9, Major(s): Philiosophy , Minor(s): Music 
	Felic Cambridge - Email: fcambridge44@cnbc.com, Section 9, Major(s): Philiosophy , Minor(s): Music 
Group 2:
	Titos Thecham - Email: tthecham5w@zimbio.com, Section 9, Major(s): Political Science , Minor(s): Philiosophy 
	Emilee Ungerecht - Email: eungerechtq3@latimes.com, Section 9, Major(s): Computer Science 
	Ceil Mabbe - Email: cmabbent@statcounter.com, Section 9, Major(s): Statistics , Minor(s): Physics 
Group 3:
	Maurie Blouet - Email: mblouetif@google.co.uk, Section 9, Major(s): Women & Gender Studies , Minor(s): Political Science 
	Khalil Linskey - Email: klinskey2j@narod.ru, Section 9, Major(s): Statistics , Minor(s): Physics 
	Herold MacGorman - Email: hmacgormank5@networksolutions.com, Section 9, Major(s): Statistics 
Group 4:
	Lynnea Vercruysse - Email: lvercruysseia@stumbleupon.com, Section 9, Major(s): Philiosophy 
	Bonnibelle Adams - Email: badamso1@usda.gov, Section 9, Major(s): Psychology 
	Cob Brushfield - Email: cbrushfieldoa@time.com, Section 9, Major(s): Statistics , Minor(s): Political Science 
Group 5:
	Jorge Rodgier - Email: jrodgier42@yolasite.com, Section 9, Major(s): Music , Minor(s): Mathematics 
	Sigismondo Roddan - Email: sroddank1@pen.io, Section 9, Major(s): Philiosophy , Minor(s): Music 
	Forrester Spanton - Email: fspantono@com.com, Section 9, Major(s): Philiosophy , Minor(s): Music 
Group 6:
	Vergil Nelle - Email: vnellees@reuters.com, Section 9, Major(s): Philiosophy , Minor(s): Music 
	Lib Liff - Email: lliffox@sfgate.com, Section 9, Major(s): Psychology , Minor(s): Music 
	Waite Fidian - Email: wfidianbw@ftc.gov, Section 9, Major(s): Physics , Minor(s): Music Mathematics
Group 7:
	Inge Besson - Email: ibessonu@scientificamerican.com, Section 9, Major(s): Women & Gender Studies , Minor(s): Political Science 
	Bryana Rizzi - Email: brizzie7@nymag.com, Section 9, Major(s): Philiosophy , Minor(s): Music 
	Hedda Lilloe - Email: hlilloek3@earthlink.net, Section 9, Major(s): Psychology , Minor(s): Music 
Group 8:
	Charisse Mikalski - Email: cmikalskig2@ask.com, Section 9, Major(s): Statistics , Minor(s): Philiosophy 
	Karlen Tredget - Email: ktredgetcs@ebay.co.uk, Section 9, Major(s): Political Science , Minor(s): Philiosophy 
	Britte Bullus - Email: bbullus55@myspace.com, Section 9, Major(s): Women & Gender Studies , Minor(s): Political Science 
Group 9:
	Branden Summersett - Email: bsummersett1l@craigslist.org, Section 9, Major(s): Political Science , Minor(s): Philiosophy 
	Skell Akers - Email: sakersc1@dailymotion.com, Section 9, Major(s): Women & Gender Studies 
	Isidoro Sherrum - Email: isherrumgj@shop-pro.jp, Section 9, Major(s): Philiosophy , Minor(s): Music 
Group 10:
	Raffarty Muccino - Email: rmuccino6u@dion.ne.jp, Section 9, Major(s): Statistics , Minor(s): Philiosophy 
	Monro Lambird - Email: mlambirdlm@senate.gov, Section 9, Major(s): Philiosophy , Minor(s): Music 
	Tarrah Mathelon - Email: tmathelonmi@hatena.ne.jp, Section 9, Major(s): Psychology , Minor(s): Music 
Group 11:
	Glyn Fiddymont - Email: gfiddymont7l@bandcamp.com, Section 9, Major(s): Physics , Minor(s): Music Mathematics
	Everard James - Email: ejamescv@sourceforge.net, Section 9, Major(s): Statistics , Minor(s): Physics 
	Fairleigh Esilmon - Email: fesilmon8f@theguardian.com, Section 9, Major(s): Philiosophy , Minor(s): Music 
Group 12:
	Willi Damp - Email: wdampnp@squidoo.com, Section 9, Major(s): Philiosophy , Minor(s): Music 
	Ottilie MacAllester - Email: omacallestero2@uol.com.br, Section 9, Major(s): Statistics , Minor(s): Physics 
	Ephrem Jakobsson - Email: ejakobssonew@over-blog.com, Section 9, Major(s): Statistics , Minor(s): Physics 
Group 13:
	Manon Tippell - Email: mtippelldl@hexun.com, Section 9, Major(s): Philiosophy , Minor(s): Music 
	Amelia MacTrustrie - Email: amactrustriee9@harvard.edu, Section 9, Major(s): Psychology , Minor(s): Music 
	Delilah Jacklin - Email: djacklin45@exblog.jp, Section 9, Major(s): Physics , Minor(s): Music Mathematics
Group 14:
	Giordano Ashdown - Email: gashdownnu@google.co.jp, Section 9, Major(s): Women & Gender Studies 
	Verine Cleary - Email: vclearyna@jigsy.com, Section 9, Major(s): Philiosophy , Minor(s): Music 
	Fidole Merrydew - Email: fmerrydewmz@ning.com, Section 9, Major(s): Statistics 
Group 15:
	Beryle Abbotts - Email: babbotts4a@taobao.com, Section 9, Major(s): Women & Gender Studies 
	El Deare - Email: edeareiv@digg.com, Section 9, Major(s): Philiosophy , Minor(s): Music 
	Shelby Snugg - Email: ssnuggfg@tiny.cc, Section 9, Major(s): Sociology , Minor(s): Philiosophy 
Group 16:
	Jania Pound - Email: jpoundgi@delicious.com, Section 9, Major(s): Music , Minor(s): Mathematics 
	Louise Wisdish - Email: lwisdishpd@cbslocal.com, Section 9, Major(s): Psychology 
	Eleanora Boyack - Email: eboyackct@artisteer.com, Section 9, Major(s): Psychology 
Group 17:
	Jeanelle Galgey - Email: jgalgeymg@reference.com, Section 9, Major(s): Philiosophy , Minor(s): Music 
	Udell Gething - Email: ugethingl8@umich.edu, Section 9, Major(s): Physics , Minor(s): Music Mathematics
	Somerset Benoiton - Email: sbenoitondr@oakley.com, Section 9, Major(s): Women & Gender Studies , Minor(s): Political Science 
Group 18:
	Joane Hamstead - Email: jhamsteadnq@europa.eu, Section 9, Major(s): Physics , Minor(s): Music Mathematics
	Mackenzie Briddle - Email: mbriddleff@hostgator.com, Section 9, Major(s): Psychology 
	Allegra Kamen - Email: akamencq@tripadvisor.com, Section 9, Major(s): Philiosophy , Minor(s): Music 
Group 19:
	Duff MacAvaddy - Email: dmacavaddyb3@intel.com, Section 9, Major(s): Psychology , Minor(s): Music 
	Rosette Old - Email: roldkm@booking.com, Section 9, Major(s): Philiosophy , Minor(s): Music 
	Emili Fransson - Email: efranssonl7@homestead.com, Section 9, Major(s): Philiosophy , Minor(s): Music 
Group 20:
	Kelbee Paynton - Email: kpaynton52@bing.com, Section 9, Major(s): Psychology , Minor(s): Music 
	Anabella Wedgbrow - Email: awedgbrowm1@cornell.edu, Section 9, Major(s): Philiosophy 
	Keane Walley - Email: kwalleypa@utexas.edu, Section 9, Major(s): History 
Group 21:
	Terence Lage - Email: tlagehp@skyrock.com, Section 9, Major(s): Philiosophy , Minor(s): Music 
	Rory Burehill - Email: rburehillm3@ted.com, Section 9, Major(s): Psychology , Minor(s): Philiosophy 
	Tobye Mariot - Email: tmariothr@bigcartel.com, Section 9, Major(s): Psychology , Minor(s): Music 
Group 22:
	Addy Niccolls - Email: aniccollsi9@imgur.com, Section 9, Major(s): Music , Minor(s): Mathematics 
	Keri Brodley - Email: kbrodleyrj@psu.edu, Section 9, Major(s): Statistics , Minor(s): Political Science 
	Claus Quenell - Email: cquenell7k@cyberchimps.com, Section 9, Major(s): Philiosophy , Minor(s): Music 
Group 23:
	Juliana Kilbey - Email: jkilbey5u@t.co, Section 9, Major(s): Philiosophy , Minor(s): Music 
	Tami Mayze - Email: tmayze5z@state.tx.us, Section 9, Major(s): Statistics 
	Leontyne Abbe - Email: labbemx@dion.ne.jp, Section 9, Major(s): Psychology 
Group 24:
	Ola Lob - Email: olobmk@reference.com, Section 9, Major(s): Statistics , Minor(s): Physics 
	Mirabella Heaphy - Email: mheaphy4z@biblegateway.com, Section 9, Major(s): Philiosophy , Minor(s): Music 
	Dianna Syms - Email: dsyms2e@dot.gov, Section 9, Major(s): Philiosophy , Minor(s): Music 
Group 25:
	Karney Kelwaybamber - Email: kkelwaybambert@livejournal.com, Section 9, Major(s): Statistics , Minor(s): Physics 
	Melody Ivanchenkov - Email: mivanchenkovb0@mail.ru, Section 9, Major(s): Philiosophy , Minor(s): Music 
	Aubree Noirel - Email: anoirelfd@nba.com, Section 9, Major(s): Philiosophy , Minor(s): Music 
Group 26:
	Sibilla Bronot - Email: sbronotoq@oaic.gov.au, Section 9, Major(s): Statistics , Minor(s): Political Science 
	Lisette Tussaine - Email: ltussainejg@macromedia.com, Section 9, Major(s): Philiosophy 
	Vickie MacGregor - Email: vmacgregor9a@soup.io, Section 9, Major(s): Philiosophy , Minor(s): Music 
Group 27:
	Bennie Bidgod - Email: bbidgodfi@furl.net, Section 9, Major(s): Women & Gender Studies , Minor(s): Political Science 
	Ludovico Mouth - Email: lmouth39@lulu.com, Section 9, Major(s): Philiosophy , Minor(s): Music 
	Brady Bidgod - Email: bbidgodnf@issuu.com, Section 9, Major(s): Women & Gender Studies , Minor(s): Political Science 
Group 28:
	Rosella Knill - Email: rknilloi@pinterest.com, Section 9, Major(s): Statistics , Minor(s): Physics 
Group 29:
	Misha Silcocks - Email: msilcocks4w@csmonitor.com, Section 3, Major(s): Mechanical Engineering 
	Mac Blacksell - Email: mblacksellf7@comsenz.com, Section 3, Major(s): Finance Economics
	Brewster Calafato - Email: bcalafatof6@sphinn.com, Section 3, Major(s): English Criminology
Group 30:
	Rosalind Stiell - Email: rstiell31@vistaprint.com, Section 3, Major(s): History 
	Rhonda Gaitskell - Email: rgaitskellhi@hostgator.com, Section 3, Major(s): English 
	Allx Candlish - Email: acandlishn5@opera.com, Section 3, Major(s): Finance Economics
Group 31:
	Byran Trustey - Email: btrustey3r@usgs.gov, Section 3, Major(s): Criminology , Minor(s): Computer Science 
	Maurene Kinghorne - Email: mkinghorne18@shop-pro.jp, Section 3, Major(s): English Economics
	Basil Trusty - Email: btrustyio@google.ca, Section 3, Major(s): English , Minor(s): Computer Science 
Group 32:
	Sephira Shilstone - Email: sshilstonean@diigo.com, Section 3, Major(s): Criminology 
	Stormy Tebald - Email: stebaldbk@naver.com, Section 3, Major(s): English , Minor(s): Computer Science 
	Cami Skin - Email: cskinn2@amazonaws.com, Section 3, Major(s): Chemistry 
Group 33:
	Temple Stayte - Email: tstayte9b@woothemes.com, Section 3, Major(s): Physics 
	Georges Copcote - Email: gcopcoteha@reference.com, Section 3, Major(s): Economics , Minor(s): Computer Science 
	Dore Sleith - Email: dsleith30@123-reg.co.uk, Section 3, Major(s): Health & Exercise Science 
Group 34:
	Tobye Ablott - Email: tablottjt@live.com, Section 3, Major(s): Criminology Computer Science
	Tabbitha Dooler - Email: tdooler3g@yolasite.com, Section 3, Major(s): Economics , Minor(s): Computer Science 
	Harriot Pillifant - Email: hpillifantfr@senate.gov, Section 3, Major(s): English , Minor(s): Computer Science 
Group 35:
	Whitney Shine - Email: wshineg7@statcounter.com, Section 3, Major(s): Chemistry 
	Fairleigh Smithen - Email: fsmithenp9@ycombinator.com, Section 3, Major(s): Finance 
	Zelma Archdeckne - Email: zarchdecknecx@cnbc.com, Section 3, Major(s): Economics Computer Science
Group 36:
	Kattie Stretton - Email: kstrettonlg@psu.edu, Section 3, Major(s): Criminology 
	Sunny Vonderdell - Email: svonderdellkf@youtube.com, Section 3, Major(s): English , Minor(s): Computer Science 
	Allsun Thacke - Email: athackefe@canalblog.com, Section 3, Major(s): Physics 
Group 37:
	Teddy Shipston - Email: tshipstonl6@gnu.org, Section 3, Major(s): Music 
	Allegra Mainland - Email: amainland9u@google.pl, Section 3, Major(s): English Economics
	Shurlock Agdahl - Email: sagdahl21@histats.com, Section 3, Major(s): Criminology Computer Science
Group 38:
	Evania Godspeede - Email: egodspeedei3@ted.com, Section 3, Major(s): English 
	Virgie Thirwell - Email: vthirwell85@theglobeandmail.com, Section 3, Major(s): Finance 
	Alon Setterfield - Email: asetterfieldo5@elpais.com, Section 3, Major(s): Finance 
Group 39:
	Maurita Storres - Email: mstorresmc@parallels.com, Section 3, Major(s): History 
	Deloria Tremain - Email: dtremain82@ibm.com, Section 3, Major(s): Criminology , Minor(s): Computer Science 
	Hyacinthe Tinto - Email: htinto3f@cbslocal.com, Section 3, Major(s): Women & Gender Studies 
Group 40:
	Howey D'Almeida - Email: hdalmeida84@joomla.org, Section 3, Major(s): English Criminology
	Wilek Bedome - Email: wbedomeot@issuu.com, Section 3, Major(s): Finance Economics
	Lesley Shaudfurth - Email: lshaudfurth7m@va.gov, Section 3, Major(s): Political Science 
Group 41:
	Roxana Thayre - Email: rthayre97@archive.org, Section 3, Major(s): Mechanical Engineering 
	Kingston Le Moucheux - Email: klemoucheux8z@bizjournals.com, Section 3, Major(s): English Economics
	Kipp Austins - Email: kaustins61@sina.com.cn, Section 3, Major(s): Economics Computer Science
Group 42:
	Olenka Ganderton - Email: ogandertoney@nytimes.com, Section 3, Major(s): Economics , Minor(s): Computer Science 
	Jeremy Iacovozzo - Email: jiacovozzo5j@hubpages.com, Section 3, Major(s): English 
	Kayne Wooton - Email: kwootonos@ask.com, Section 3, Major(s): Criminology , Minor(s): Computer Science 
Group 43:
	Hilton Stieger - Email: hstiegerjw@google.it, Section 3, Major(s): History 
	Fedora Comiskey - Email: fcomiskeyig@zimbio.com, Section 3, Major(s): Economics , Minor(s): Computer Science 
	Antoinette Buckie - Email: abuckieap@ustream.tv, Section 3, Major(s): English Criminology
Group 44:
	Hugo Hardistry - Email: hhardistryel@baidu.com, Section 3, Major(s): English 
	Loise Aslott - Email: laslottdb@51.la, Section 3, Major(s): Finance Economics
	Aprilette Storcke - Email: astorcke28@google.de, Section 3, Major(s): Interdisciplinary Studies 
Group 45:
	Darda Garbutt - Email: dgarbutt2l@joomla.org, Section 3, Major(s): Economics , Minor(s): Computer Science 
	Sly Swinford - Email: sswinford7p@dailymail.co.uk, Section 3, Major(s): Statistics 
	Molly Alsop - Email: malsophh@google.es, Section 3, Major(s): Criminology Computer Science
Group 46:
	Justen Constance - Email: jconstance2y@amazonaws.com, Section 3, Major(s): English Criminology
	Goldarina Sill - Email: gsill7r@hhs.gov, Section 3, Major(s): Economics Criminology, Minor(s): Computer Science 
	Stacee Paxman - Email: spaxman4o@ft.com, Section 3, Major(s): English , Minor(s): Computer Science 
Group 47:
	Audie Pickvance - Email: apickvance79@kickstarter.com, Section 3, Major(s): English , Minor(s): Computer Science 
	Reinwald Eloi - Email: reloifj@npr.org, Section 3, Major(s): Economics , Minor(s): Computer Science 
	Clementius Stemp - Email: cstempfc@imgur.com, Section 3, Major(s): Music 
Group 48:
	Malory Alcorn - Email: malcornnw@vkontakte.ru, Section 3, Major(s): Criminology Computer Science
	Daryn Glastonbury - Email: dglastonbury6w@51.la, Section 3, Major(s): Economics , Minor(s): Computer Science 
	Jayson Shieldon - Email: jshieldon23@apple.com, Section 3, Major(s): English , Minor(s): Computer Science 
Group 49:
	Chick Tellwright - Email: ctellwright1b@hibu.com, Section 3, Major(s): History 
	Alley De Giorgio - Email: adegiorgiol0@last.fm, Section 3, Major(s): English 
	Jerrilee Tummond - Email: jtummondgx@telegraph.co.uk, Section 3, Major(s): English , Minor(s): Computer Science 
Group 50:
	Delmer Tolussi - Email: dtolussi77@digg.com, Section 3, Major(s): Criminology , Minor(s): Computer Science 
	Agata Sturm - Email: asturmr2@nyu.edu, Section 3, Major(s): Journalism 
	Wynne Shwalbe - Email: wshwalbee2@pen.io, Section 3, Major(s): History 
Group 51:
	Dov Tandy - Email: dtandylu@indiatimes.com, Section 3, Major(s): Computer Science 
	Sayres Zanni - Email: szannihf@dot.gov, Section 3, Major(s): Computer Engineering Communication Studies
	Letizia Thornber - Email: lthornber4q@yahoo.com, Section 3, Major(s): Health & Exercise Science 
Group 52:
	Berkly Brace - Email: bbracehj@tripod.com, Section 3, Major(s): Finance Economics
	Allyn Silberschatz - Email: asilberschatz8v@exblog.jp, Section 3, Major(s): Computer Engineering 
	Sharlene Cason - Email: scason90@nsw.gov.au, Section 3, Major(s): Finance 
Group 53:
	Ximenes St. Aubyn - Email: xstaubyne0@hatena.ne.jp, Section 3, Major(s): English , Minor(s): Computer Science 
	Mora Synder - Email: msynderdm@irs.gov, Section 3, Major(s): Physics 
	Charlton Sumner - Email: csumner9f@stanford.edu, Section 3, Major(s): Statistics 
Group 54:
	Britney Benning - Email: bbenninggc@washingtonpost.com, Section 3, Major(s): English Criminology
	Ian Whitewood - Email: iwhitewoodek@uiuc.edu, Section 3, Major(s): Criminology , Minor(s): Computer Science 
	Nomi Benjamin - Email: nbenjaminc2@globo.com, Section 3, Major(s): Economics , Minor(s): Computer Science 
Group 55:
	Mindy Arkow - Email: markowoc@instagram.com, Section 3, Major(s): Criminology Computer Science
	Pepe Smallbone - Email: psmallbone8d@unc.edu, Section 3, Major(s): Music 
	Collie Symons - Email: csymonscd@redcross.org, Section 3, Major(s): Criminology , Minor(s): Computer Science 
Group 56:
	Brendan Roddan - Email: broddan6e@domainmarket.com, Section 3, Major(s): English , Minor(s): Computer Science 
	Lucais Shackle - Email: lshackle17@reference.com, Section 3, Major(s): Electrical Engineering 
	Hurley Sherebrook - Email: hsherebrook89@yandex.ru, Section 3, Major(s): Interdisciplinary Studies 
Group 57:
	Duff Rennock - Email: drennock3t@themeforest.net, Section 3, Major(s): English , Minor(s): Computer Science 
	Daloris Wisdish - Email: dwisdishg9@angelfire.com, Section 3, Major(s): Computer Engineering Communication Studies
Group 58:
	Ram Perott - Email: rperottai@theguardian.com, Section 1, Major(s): Biomedical Engineering 
	Delainey Pietrzak - Email: dpietrzakf3@omniture.com, Section 1, Major(s): Computer Engineering 
	Tabbie Poulgreen - Email: tpoulgreenib@shareasale.com, Section 1, Major(s): Physics 
Group 59:
	Aleda Leguay - Email: aleguay11@phoca.cz, Section 1, Major(s): Biomedical Engineering Art History, Minor(s): African American Studies Women & Gender Studies
	Claudina Cursons - Email: ccursons70@mayoclinic.com, Section 1, Major(s): Art History , Minor(s): Women & Gender Studies Statistics
	Stefano Mealiffe - Email: smealiffe3n@craigslist.org, Section 1, Major(s): Chemistry , Minor(s): Accounting 
Group 60:
	Flossie Dabel - Email: fdabelhc@japanpost.jp, Section 1, Major(s): Biology African American Studies
	Worthington Buffy - Email: wbuffy7x@nps.gov, Section 1, Major(s): Biomedical Engineering Anthropology, Minor(s): Accounting 
	Flemming Keuneke - Email: fkeunekeeg@ca.gov, Section 1, Major(s): Chemistry Biology, Minor(s): Anthropology Women & Gender Studies
Group 61:
	Fairlie Schistl - Email: fschistlfl@1688.com, Section 1, Major(s): Biology Anthropology
	Rutger Cadigan - Email: rcadigan68@seattletimes.com, Section 1, Major(s): Chemistry Art History
	Lannie Hardie - Email: lhardie65@g.co, Section 1, Major(s): Art History , Minor(s): Women & Gender Studies Statistics
Group 62:
	Angel Gillis - Email: agillis1w@webeden.co.uk, Section 1, Major(s): Biomedical Engineering Anthropology, Minor(s): Accounting Women & Gender Studies
	Issy Payfoot - Email: ipayfootc5@mediafire.com, Section 1, Major(s): Anthropology , Minor(s): Women & Gender Studies Sociology
	Emmey Reisen - Email: ereisenah@jalbum.net, Section 1, Major(s): Biology Anthropology
Group 63:
	Eula Pellatt - Email: epellatthy@cbc.ca, Section 1, Major(s): Chemistry 
	Marion Phalip - Email: mphalip5o@imdb.com, Section 1, Major(s): Interdisciplinary Studies 
	Lydia Couser - Email: lcouserdu@icq.com, Section 1, Major(s): Biology African American Studies
Group 64:
	Dugald Ion - Email: dionc6@yandex.ru, Section 1, Major(s): Art History , Minor(s): Women & Gender Studies Statistics
	Donnie Micklewicz - Email: dmicklewiczf1@godaddy.com, Section 1, Major(s): Chemistry Biology
	Stanislas Pettendrich - Email: spettendrichgo@hatena.ne.jp, Section 1, Major(s): Women & Gender Studies 
Group 65:
	Tasia Plunkett - Email: tplunkett3m@behance.net, Section 1, Major(s): Biomedical Engineering 
	Morissa Tokley - Email: mtokley8q@globo.com, Section 1, Major(s): Art History , Minor(s): Women & Gender Studies 
	Keene Goodfellowe - Email: kgoodfellowe5c@sphinn.com, Section 1, Major(s): Biomedical Engineering Art History, Minor(s): African American Studies Women & Gender Studies
Group 66:
	Elisabet Ollerearnshaw - Email: eollerearnshaw83@nyu.edu, Section 1, Major(s): Electrical Engineering 
	Pearline Pavelin - Email: ppavelin7@yandex.ru, Section 1, Major(s): Chemistry 
	Jone Bispo - Email: jbispojo@webnode.com, Section 1, Major(s): Biology , Minor(s): Accounting 
Group 67:
	Monah Medland - Email: mmedland1x@soundcloud.com, Section 1, Major(s): Chemistry , Minor(s): Accounting 
	Karen Heading - Email: kheading9n@senate.gov, Section 1, Major(s): Biomedical Engineering Art History, Minor(s): African American Studies Women & Gender Studies
	Lennard Pinel - Email: lpineli8@ebay.com, Section 1, Major(s): Mechanical Engineering 
Group 68:
	Welby Tampion - Email: wtampiony@smugmug.com, Section 1, Major(s): Anthropology , Minor(s): Women & Gender Studies 
	Luigi Deam - Email: ldeam1u@craigslist.org, Section 1, Major(s): Art History , Minor(s): Women & Gender Studies Statistics
	Zahara Cartmer - Email: zcartmer3l@163.com, Section 1, Major(s): Biology African American Studies, Minor(s): Accounting 
Group 69:
	Tuck Lipson - Email: tlipson4i@eventbrite.com, Section 1, Major(s): Chemistry , Minor(s): Anthropology Women & Gender Studies
	Chic Kilbourn - Email: ckilbourn9k@cbc.ca, Section 1, Major(s): Anthropology , Minor(s): Women & Gender Studies Sociology
	Freddi Brundale - Email: fbrundalebc@marriott.com, Section 1, Major(s): Biology , Minor(s): Accounting 
Group 70:
	Domeniga Garnson - Email: dgarnson64@freewebs.com, Section 1, Major(s): Anthropology , Minor(s): Women & Gender Studies 
	Karoline Haspineall - Email: khaspinealld3@washingtonpost.com, Section 1, Major(s): Biomedical Engineering Art History, Minor(s): African American Studies Women & Gender Studies
	Kenny Pinck - Email: kpinckdz@weibo.com, Section 1, Major(s): Criminology 
Group 71:
	Betsey Prawle - Email: bprawlebj@symantec.com, Section 1, Major(s): Electrical Engineering 
	Scotty Packham - Email: spackham2@flickr.com, Section 1, Major(s): African American Studies 
	Rosaline Aron - Email: raron2s@youtu.be, Section 1, Major(s): Chemistry Art History
Group 72:
	Barclay Boast - Email: bboastd4@artisteer.com, Section 1, Major(s): Chemistry Art History
	Maynord Jenk - Email: mjenk5b@qq.com, Section 1, Major(s): Biology African American Studies
	Ewell Packman - Email: epackmanp3@typepad.com, Section 1, Major(s): Journalism 
Group 73:
	Chad Utridge - Email: cutridge6z@tinyurl.com, Section 1, Major(s): Anthropology , Minor(s): Women & Gender Studies 
	Karmen Olifard - Email: kolifardo8@xrea.com, Section 1, Major(s): Mathematics 
	Nestor Pennicard - Email: npennicard5d@state.tx.us, Section 1, Major(s): Chemistry 
Group 74:
	Ervin Orpyne - Email: eorpyneow@51.la, Section 1, Major(s): Mathematics 
	Justino Seamer - Email: jseamerd0@home.pl, Section 1, Major(s): Anthropology , Minor(s): Women & Gender Studies 
	Alikee Mochar - Email: amochar3j@unesco.org, Section 1, Major(s): Anthropology , Minor(s): Women & Gender Studies Sociology
Group 75:
	Skipton Phillis - Email: sphilliskc@sciencedaily.com, Section 1, Major(s): Computer Engineering 
	Clementius Curcher - Email: ccurcherbd@chron.com, Section 1, Major(s): Biomedical Engineering Anthropology, Minor(s): Accounting Women & Gender Studies
	Gracia Poge - Email: gpoge9o@yale.edu, Section 1, Major(s): Chemistry 
Group 76:
	Martynne Sheals - Email: msheals1v@technorati.com, Section 1, Major(s): Biology Anthropology
	Justine Beneix - Email: jbeneix59@1und1.de, Section 1, Major(s): Anthropology , Minor(s): Women & Gender Studies 
	Justine Oloman - Email: jolomanfb@desdev.cn, Section 1, Major(s): Mechanical Engineering 
Group 77:
	Lanita MacCahey - Email: lmaccahey1t@1und1.de, Section 1, Major(s): Anthropology , Minor(s): Women & Gender Studies Sociology
	Salmon Pointon - Email: spointon3u@imgur.com, Section 1, Major(s): Finance 
	Karil Aisman - Email: kaisman9m@guardian.co.uk, Section 1, Major(s): Biology , Minor(s): Accounting 
Group 78:
	Raviv Pegrum - Email: rpegrum46@auda.org.au, Section 1, Major(s): Political Science 
	Judas Meron - Email: jmeronc7@baidu.com, Section 1, Major(s): Biology Anthropology
	Justine Lowmass - Email: jlowmass8p@mayoclinic.com, Section 1, Major(s): Anthropology , Minor(s): Women & Gender Studies Sociology
Group 79:
	Wakefield Pleager - Email: wpleager4u@gravatar.com, Section 1, Major(s): Journalism 
	Tamera Chisnall - Email: tchisnallgr@miibeian.gov.cn, Section 1, Major(s): Biology African American Studies
	Giorgia Brayley - Email: gbrayleyjp@amazon.co.jp, Section 1, Major(s): Chemistry Art History
Group 80:
	Zilvia Shambrook - Email: zshambrook66@so-net.ne.jp, Section 1, Major(s): Biology Anthropology
	Gina Hanaby - Email: ghanaby4@dyndns.org, Section 1, Major(s): Art History , Minor(s): Women & Gender Studies Statistics
	Stanwood Kettow - Email: skettow8s@sciencedaily.com, Section 1, Major(s): Biomedical Engineering Art History, Minor(s): African American Studies Women & Gender Studies
Group 81:
	Yule Betty - Email: ybetty2o@japanpost.jp, Section 1, Major(s): Anthropology , Minor(s): Women & Gender Studies 
	Hertha Flohard - Email: hflohardd2@netvibes.com, Section 1, Major(s): Biology African American Studies
	Phylys Bocken - Email: pbockenbe@flavors.me, Section 1, Major(s): Chemistry Art History
Group 82:
	Doug Hofton - Email: dhofton10@domainmarket.com, Section 1, Major(s): Biology African American Studies
	Cayla Ortzen - Email: cortzen6g@4shared.com, Section 1, Major(s): Health & Exercise Science 
	Randi Pettie - Email: rpettiep@npr.org, Section 1, Major(s): Physics 
Group 83:
	Anderson Entreis - Email: aentreisr5@discovery.com, Section 4, Major(s): Journalism Interactive Mulitmedia
	Drew Towhey - Email: dtowhey2f@mysql.com, Section 4, Major(s): Physics 
	Jerad Gettings - Email: jgettingsr6@cdbaby.com, Section 4, Major(s): Journalism Interactive Mulitmedia
Group 84:
	Morena Offord - Email: moffordrn@techcrunch.com, Section 4, Major(s): History Finance
	Salim Aiston - Email: saistoni6@cpanel.net, Section 4, Major(s): Journalism History
	Thornie Keune - Email: tkeuneli@aboutads.info, Section 4, Major(s): History , Minor(s): Criminology 
Group 85:
	Alvera Tolcharde - Email: atolchardem9@live.com, Section 4, Major(s): Computer Science 
	Averil Loomes - Email: aloomesas@ocn.ne.jp, Section 4, Major(s): History , Minor(s): English 
	Alan Mico - Email: amicoci@hp.com, Section 4, Major(s): History , Minor(s): Finance 
Group 86:
	Tonie Alstead - Email: talsteadn7@bloomberg.com, Section 4, Major(s): Journalism , Minor(s): History 
	Dorthy Hounson - Email: dhounson92@hubpages.com, Section 4, Major(s): History Finance, Minor(s): Criminology 
	Gael Doutch - Email: gdoutcha0@wisc.edu, Section 4, Major(s): Journalism History
Group 87:
	Eddy Dransfield - Email: edransfieldo6@weibo.com, Section 4, Major(s): History Finance, Minor(s): Criminology 
	Petronilla Younger - Email: pyoungerj9@tumblr.com, Section 4, Major(s): English Economics
	Bendicty Harses - Email: bharses29@mapquest.com, Section 4, Major(s): Journalism Interactive Mulitmedia
Group 88:
	Ellen Duffin - Email: eduffinnz@nasa.gov, Section 4, Major(s): Journalism History
	Birgit Calderwood - Email: bcalderwoodjc@youku.com, Section 4, Major(s): Journalism , Minor(s): History 
	Eamon Ondrich - Email: eondrichhk@amazon.co.jp, Section 4, Major(s): History Finance
Group 89:
	Meade Bredgeland - Email: mbredgelandr3@51.la, Section 4, Major(s): Journalism , Minor(s): History 
	Powell Tratton - Email: ptratton3s@techcrunch.com, Section 4, Major(s): Electrical Engineering 
	Chandal McVey - Email: cmcveyrp@wisc.edu, Section 4, Major(s): History , Minor(s): Finance 
Group 90:
	Marci Lundberg - Email: mlundbergrl@wikia.com, Section 4, Major(s): History , Minor(s): English 
	Karin Geikie - Email: kgeikiedg@mysql.com, Section 4, Major(s): Journalism Interactive Mulitmedia
	Helsa Iacomi - Email: hiacomir9@craigslist.org, Section 4, Major(s): Journalism Interactive Mulitmedia
Group 91:
	Reinhold Baugham - Email: rbaughamrc@springer.com, Section 4, Major(s): Journalism , Minor(s): History 
	Henrik Nevison - Email: hnevisonny@joomla.org, Section 4, Major(s): History Finance
	Hall MacIver - Email: hmaciverou@wufoo.com, Section 4, Major(s): History , Minor(s): English 
Group 92:
	Allie Giraldo - Email: agiraldoqz@studiopress.com, Section 4, Major(s): Journalism Interactive Mulitmedia
	Octavius Lamplugh - Email: olamplughge@ihg.com, Section 4, Major(s): History , Minor(s): Criminology 
	Alfred Dorrity - Email: adorrity95@wufoo.com, Section 4, Major(s): Journalism History
Group 93:
	Biddie Gladtbach - Email: bgladtbachhl@jimdo.com, Section 4, Major(s): Journalism Interactive Mulitmedia
	Lefty Nezey - Email: lnezeyf8@intel.com, Section 4, Major(s): History Finance
	Zulema Matzaitis - Email: zmatzaitisnl@nps.gov, Section 4, Major(s): History , Minor(s): Finance 
Group 94:
	Violet Braker - Email: vbrakerbq@wisc.edu, Section 4, Major(s): Journalism , Minor(s): History 
	Eddie Eilles - Email: eeillesra@home.pl, Section 4, Major(s): Journalism History
	Hy Castellaccio - Email: hcastellacciof9@digg.com, Section 4, Major(s): Journalism History
Group 95:
	Enrico Gellion - Email: egellionr0@gov.uk, Section 4, Major(s): Journalism Interactive Mulitmedia
	Frants Peaurt - Email: fpeaurtbn@liveinternet.ru, Section 4, Major(s): History Finance
	Agathe Cabera - Email: acaberamd@xrea.com, Section 4, Major(s): Journalism , Minor(s): History 
Group 96:
	Victoir Chrichton - Email: vchrichtonfu@zdnet.com, Section 4, Major(s): Journalism History
	Glennis Winckles - Email: gwincklesd@digg.com, Section 4, Major(s): English Economics
	Kasper Tour - Email: ktourp6@usnews.com, Section 4, Major(s): Statistics 
Group 97:
	Ludovico Kaliszewski - Email: lkaliszewskimr@spiegel.de, Section 4, Major(s): History , Minor(s): Criminology 
	Pam Augie - Email: paugie1e@studiopress.com, Section 4, Major(s): Journalism , Minor(s): History 
	Percival Giddens - Email: pgiddensjx@tripadvisor.com, Section 4, Major(s): Journalism Interactive Mulitmedia
Group 98:
	Jude Triggs - Email: jtriggsdq@slashdot.org, Section 4, Major(s): Statistics 
	Ulises Tresise - Email: utresiserm@exblog.jp, Section 4, Major(s): History 
	Abram Chessman - Email: achessmanr4@netvibes.com, Section 4, Major(s): Journalism History
Group 99:
	Jacobo Frise - Email: jfrisero@discuz.net, Section 4, Major(s): History Finance, Minor(s): Criminology 
	Willi Larman - Email: wlarman7c@bluehost.com, Section 4, Major(s): History , Minor(s): Criminology 
	Wendi Zapatero - Email: wzapaterorq@opera.com, Section 4, Major(s): History Health & Exercise Science
Group 100:
	Shurwood Trownson - Email: strownson1o@mac.com, Section 4, Major(s): Statistics 
	Darsie Hardcastle - Email: dhardcastleki@hhs.gov, Section 4, Major(s): Journalism Interactive Mulitmedia
	Roselin Mulholland - Email: rmulhollandju@cbslocal.com, Section 4, Major(s): English Economics
Group 101:
	Allister Lilywhite - Email: alilywhitegz@europa.eu, Section 4, Major(s): History , Minor(s): Criminology 
	Hazel Gibson - Email: hgibsonp2@dedecms.com, Section 4, Major(s): History Finance, Minor(s): Criminology 
	Michaela Wandtke - Email: mwandtkeft@amazon.co.jp, Section 4, Major(s): History Health & Exercise Science
Group 102:
	Shaylynn Murden - Email: smurden4r@joomla.org, Section 4, Major(s): History , Minor(s): Finance 
	Inez Caris - Email: icaris5p@nsw.gov.au, Section 4, Major(s): Journalism , Minor(s): History 
	Estella Tremblet - Email: etrembletg3@so-net.ne.jp, Section 4, Major(s): Women & Gender Studies 
Group 103:
	Pablo Hoppner - Email: phoppnerir@soundcloud.com, Section 4, Major(s): Journalism Interactive Mulitmedia
	Kayle Jackett - Email: kjackett87@hostgator.com, Section 4, Major(s): History , Minor(s): Criminology 
	Karrah Brigstock - Email: kbrigstock3z@jiathis.com, Section 4, Major(s): Journalism , Minor(s): History 
Group 104:
	Ethe Todarello - Email: etodarelloe8@intel.com, Section 4, Major(s): Physics 
	Ellen Marchiso - Email: emarchisoi5@friendfeed.com, Section 4, Major(s): History , Minor(s): Finance 
	Osbert Willerstone - Email: owillerstonelx@prlog.org, Section 4, Major(s): History Health & Exercise Science
Group 105:
	Asher Olyfant - Email: aolyfantcf@google.pl, Section 4, Major(s): English Economics
	Winne Balderstone - Email: wbalderstone6k@businesswire.com, Section 4, Major(s): Journalism , Minor(s): History 
	Hans Halsall - Email: hhalsallkh@xrea.com, Section 4, Major(s): History Finance, Minor(s): Criminology 
Group 106:
	Beatrix Algate - Email: balgate7f@accuweather.com, Section 4, Major(s): Journalism History
Group 107:
	Brnaba Kenningley - Email: bkenningleyaj@umn.edu, Section 5, Major(s): Chemistry Women & Gender Studies, Minor(s): Anthropology 
	Brynne Bazek - Email: bbazek57@webnode.com, Section 5, Major(s): Accounting Statistics, Minor(s): Psychology 
	Margarita Crosfeld - Email: mcrosfeld4x@soundcloud.com, Section 5, Major(s): Music Mathematics
Group 108:
	Herman Barsham - Email: hbarshamcz@mozilla.org, Section 5, Major(s): African American Studies Women & Gender Studies, Minor(s): Statistics 
	Gabriele Peacham - Email: gpeachamgm@geocities.jp, Section 5, Major(s): Sociology Psychology
	Aubrey Sarten - Email: asarten34@tmall.com, Section 5, Major(s): Journalism Interdisciplinary Studies
Group 109:
	Mercy Delgaty - Email: mdelgatydj@pbs.org, Section 5, Major(s): Music Mathematics
	Birdie Rois - Email: brois1y@arizona.edu, Section 5, Major(s): Communication Studies , Minor(s): Biology Accounting
	Winona Gossage - Email: wgossagebt@tinypic.com, Section 5, Major(s): Music Mathematics
Group 110:
	Gonzales Jordin - Email: gjordin2c@creativecommons.org, Section 5, Major(s): Music Mathematics
	Cherri Pflieger - Email: cpflieger62@unc.edu, Section 5, Major(s): Accounting Psychology, Minor(s): Statistics 
	Ara Breyt - Email: abreytc8@miibeian.gov.cn, Section 5, Major(s): Biomedical Engineering , Minor(s): Accounting 
Group 111:
	Sheelagh Wickersley - Email: swickersleys@cdbaby.com, Section 5, Major(s): Sociology 
	Madge Wapple - Email: mwapplec4@alexa.com, Section 5, Major(s): African American Studies Women & Gender Studies
	Mikol Stanyland - Email: mstanyland71@nih.gov, Section 5, Major(s): Biology , Minor(s): Accounting 
Group 112:
	Lonna Hillen - Email: lhillenfm@globo.com, Section 5, Major(s): Chemistry Women & Gender Studies, Minor(s): Anthropology 
	Ram Le Noury - Email: rlenouryhe@jiathis.com, Section 5, Major(s): Communication Studies , Minor(s): Biology 
	Rhiamon Rozea - Email: rrozea8o@amazonaws.com, Section 5, Major(s): African American Studies Women & Gender Studies, Minor(s): Statistics 
Group 113:
	Ivett Kopman - Email: ikopman3b@salon.com, Section 5, Major(s): Political Science Philiosophy
	Mellisent Jagson - Email: mjagson1h@nba.com, Section 5, Major(s): Music Mathematics
	Addy Worsall - Email: aworsallhw@themeforest.net, Section 5, Major(s): Accounting Psychology, Minor(s): Statistics 
Group 114:
	Saunderson Spray - Email: sspray6y@theglobeandmail.com, Section 5, Major(s): African American Studies Women & Gender Studies
	Tally Franzonetti - Email: tfranzonettim6@moonfruit.com, Section 5, Major(s): Women & Gender Studies Statistics
	Billie Presswell - Email: bpresswellhs@nasa.gov, Section 5, Major(s): Sociology Psychology
Group 115:
	Neils Barthel - Email: nbarthelgq@zimbio.com, Section 5, Major(s): Accounting Statistics, Minor(s): Psychology 
	Roarke St Ledger - Email: rstledgerqy@mediafire.com, Section 5, Major(s): Journalism Interdisciplinary Studies
	Tades Goudie - Email: tgoudieev@webs.com, Section 5, Major(s): Sociology Political Science
Group 116:
	Nikolaus Silkston - Email: nsilkstonly@pinterest.com, Section 5, Major(s): Journalism Interdisciplinary Studies
	Tann Sleet - Email: tsleet7w@wikipedia.org, Section 5, Major(s): Biology , Minor(s): Accounting 
	Travis Leonard - Email: tleonardjf@imgur.com, Section 5, Major(s): Music Mathematics, Minor(s): Interdisciplinary Studies 
Group 117:
	Hartwell Seldon - Email: hseldon13@shareasale.com, Section 5, Major(s): Communication Studies , Minor(s): Biology 
	Ilene Swin - Email: iswin4c@google.com, Section 5, Major(s): Accounting Psychology, Minor(s): Statistics 
	Saidee Zamora - Email: szamora7s@blogspot.com, Section 5, Major(s): Accounting Psychology, Minor(s): Statistics 
Group 118:
	Sanson Marrington - Email: smarringtonad@whitehouse.gov, Section 5, Major(s): Accounting Women & Gender Studies, Minor(s): Statistics 
	Urbain Miell - Email: umiellcy@jalbum.net, Section 5, Major(s): Accounting Psychology, Minor(s): Statistics 
	Juline MacAlees - Email: jmacalees8u@craigslist.org, Section 5, Major(s): Communication Studies , Minor(s): Biology Accounting
Group 119:
	Ursulina Geldart - Email: ugeldartlt@howstuffworks.com, Section 5, Major(s): Chemistry Women & Gender Studies, Minor(s): Anthropology 
	Rachelle Mulhill - Email: rmulhillc3@ask.com, Section 5, Major(s): Accounting Psychology, Minor(s): Statistics 
	Dare Clementi - Email: dclementiay@un.org, Section 5, Major(s): Music Mathematics, Minor(s): Journalism 
Group 120:
	Ninette Zecchinelli - Email: nzecchinelliqi@usda.gov, Section 5, Major(s): Computer Science 
	Franciska Sycamore - Email: fsycamore7z@netvibes.com, Section 5, Major(s): Communication Studies , Minor(s): Biology 
	Clarey Kerans - Email: ckerans98@studiopress.com, Section 5, Major(s): Music Mathematics, Minor(s): Interdisciplinary Studies 
Group 121:
	Dick Shearmur - Email: dshearmurlj@flavors.me, Section 5, Major(s): Journalism Interdisciplinary Studies
	Waneta Cammiemile - Email: wcammiemilec9@histats.com, Section 5, Major(s): Chemistry Women & Gender Studies, Minor(s): African American Studies 
	Alexis Baunton - Email: abaunton7t@t-online.de, Section 5, Major(s): African American Studies Women & Gender Studies, Minor(s): Statistics 
Group 122:
	Garner Trustrie - Email: gtrustrie2m@cisco.com, Section 5, Major(s): Accounting Psychology, Minor(s): Statistics 
	Zoe Simeons - Email: zsimeonsj@1und1.de, Section 5, Major(s): Journalism Interdisciplinary Studies
	Melantha Baldinotti - Email: mbaldinotti4d@china.com.cn, Section 5, Major(s): African American Studies Women & Gender Studies, Minor(s): Statistics 
Group 123:
	Valry Soughton - Email: vsoughton6x@naver.com, Section 5, Major(s): Accounting Psychology, Minor(s): Statistics 
	Gabie Grissett - Email: ggrissett6r@ovh.net, Section 5, Major(s): Political Science Philiosophy
	Pascal Gianni - Email: pgiannicw@sohu.com, Section 5, Major(s): Women & Gender Studies Statistics
Group 124:
	Rogerio Coppeard - Email: rcoppeardnh@devhub.com, Section 5, Major(s): Chemistry Women & Gender Studies, Minor(s): Anthropology 
	Ermentrude Vinck - Email: evinckng@hostgator.com, Section 5, Major(s): Accounting Psychology, Minor(s): Statistics 
	Selene Witard - Email: switardj5@people.com.cn, Section 5, Major(s): Communication Studies , Minor(s): Biology 
Group 125:
	Baron Paulton - Email: bpaultonca@google.de, Section 5, Major(s): Communication Studies , Minor(s): Biology Accounting
	Delly Byre - Email: dbyrem@intel.com, Section 5, Major(s): Music Mathematics, Minor(s): Journalism 
	Yardley Revely - Email: yrevelyns@ibm.com, Section 5, Major(s): Sociology Psychology
Group 126:
	Abbey Denerley - Email: adenerleydt@printfriendly.com, Section 5, Major(s): Accounting Statistics, Minor(s): Psychology 
	Bren Samarth - Email: bsamarthgf@prlog.org, Section 5, Major(s): Journalism Interdisciplinary Studies
	Cam Lamacraft - Email: clamacraftk0@squidoo.com, Section 5, Major(s): Music Mathematics, Minor(s): Interdisciplinary Studies 
Group 127:
	Cristian Geddis - Email: cgeddisml@goo.gl, Section 5, Major(s): Women & Gender Studies Statistics
	Morris Conkling - Email: mconklingld@telegraph.co.uk, Section 5, Major(s): Accounting Statistics, Minor(s): Psychology 
	Danette Pirrey - Email: dpirreyk4@people.com.cn, Section 5, Major(s): Sociology Psychology
Group 128:
	Loreen Brockhurst - Email: lbrockhurstb8@craigslist.org, Section 5, Major(s): Accounting Statistics, Minor(s): Psychology 
	Barrie Yielding - Email: byieldingj2@ezinearticles.com, Section 5, Major(s): Accounting Psychology, Minor(s): Statistics 
	Silva Skryne - Email: sskryneii@quantcast.com, Section 5, Major(s): Biology , Minor(s): Accounting 
Group 129:
	Glynnis Gregoire - Email: ggregoirend@ustream.tv, Section 5, Major(s): Sociology Political Science
	Catina Aistrop - Email: caistropls@nbcnews.com, Section 5, Major(s): Accounting Statistics, Minor(s): Psychology 
	Roanna Ceney - Email: rceney2n@princeton.edu, Section 5, Major(s): African American Studies Women & Gender Studies, Minor(s): Sociology 
Group 130:
	Simone Cockle - Email: scocklekl@stanford.edu, Section 5, Major(s): Music Mathematics, Minor(s): Journalism 
	Garnet Lorant - Email: glorant1r@google.pl, Section 5, Major(s): Accounting Women & Gender Studies, Minor(s): Statistics 
	Gregoor Ingree - Email: gingreedn@people.com.cn, Section 5, Major(s): Political Science Philiosophy
Group 131:
	Garwood Farquharson - Email: gfarquharsonka@booking.com, Section 5, Major(s): Chemistry Women & Gender Studies, Minor(s): Anthropology 
	Adelle Gras - Email: agrasjl@independent.co.uk, Section 5, Major(s): Women & Gender Studies Statistics, Minor(s): Psychology 
	Hollyanne Bortoluzzi - Email: hbortoluzzi67@jigsy.com, Section 5, Major(s): Biomedical Engineering , Minor(s): Accounting 
Group 132:
	Schuyler Wardlaw - Email: swardlawjq@tiny.cc, Section 5, Major(s): Communication Studies , Minor(s): Biology 
	Westbrooke Roseman - Email: wrosemanon@homestead.com, Section 5, Major(s): Journalism Interdisciplinary Studies
	Joli Chesney - Email: jchesneydv@imageshack.us, Section 5, Major(s): Chemistry Women & Gender Studies, Minor(s): Anthropology 
Group 133:
	Kittie Vawton - Email: kvawtoneh@vinaora.com, Section 5, Major(s): Communication Studies , Minor(s): Biology 
	Tonye Bunn - Email: tbunnhb@artisteer.com, Section 5, Major(s): Accounting Statistics, Minor(s): Psychology 
	Winfred Fildes - Email: wfildes8t@360.cn, Section 5, Major(s): Chemistry Women & Gender Studies, Minor(s): Anthropology 
Group 134:
	Georgianne De Anesy - Email: gdeanesy63@seesaa.net, Section 5, Major(s): African American Studies Women & Gender Studies, Minor(s): Sociology 
	Erick Dykas - Email: edykasdw@mashable.com, Section 5, Major(s): Communication Studies , Minor(s): Biomedical Engineering 
	Ameline Blakeston - Email: ablakestone6@creativecommons.org, Section 5, Major(s): Music Mathematics, Minor(s): Journalism 
Group 135:
	Cyndia Giraudy - Email: cgiraudy7y@hubpages.com, Section 5, Major(s): Chemistry Women & Gender Studies, Minor(s): Anthropology 
	Blake Goghin - Email: bgoghinjj@newsvine.com, Section 5, Major(s): Sociology Political Science
	Avis Skokoe - Email: askokoeku@deliciousdays.com, Section 5, Major(s): Biology , Minor(s): Accounting 
Group 136:
	Eduard Renyard - Email: erenyardg8@msu.edu, Section 5, Major(s): Communication Studies , Minor(s): Biology Accounting
	Fran Aspinall - Email: faspinallae@un.org, Section 5, Major(s): African American Studies Women & Gender Studies, Minor(s): Statistics 
	Joelle Huffey - Email: jhuffeym8@dailymotion.com, Section 5, Major(s): Chemistry Women & Gender Studies, Minor(s): Anthropology 
Group 137:
	Bonita MacRanald - Email: bmacranald2g@sina.com.cn, Section 5, Major(s): Political Science Philiosophy
	Dede Chanders - Email: dchandersjn@cloudflare.com, Section 5, Major(s): Accounting Statistics, Minor(s): Psychology 
	Mead Rumbelow - Email: mrumbelowmj@instagram.com, Section 5, Major(s): Sociology Psychology, Minor(s): Philiosophy 
Group 138:
	Karoly Yemm - Email: kyemm2q@yolasite.com, Section 5, Major(s): Biology , Minor(s): Accounting 
	Norby Neaverson - Email: nneaversonk8@photobucket.com, Section 5, Major(s): Accounting Psychology, Minor(s): Statistics 
	Kellsie Kelling - Email: kkelling6n@go.com, Section 5, Major(s): Music Mathematics
Group 139:
	Mikey Rowley - Email: mrowleyov@hexun.com, Section 5, Major(s): Journalism Interdisciplinary Studies
	Ardys Sirmon - Email: asirmoneo@shareasale.com, Section 5, Major(s): Journalism Interdisciplinary Studies
	Marrilee Nutley - Email: mnutleyn1@edublogs.org, Section 5, Major(s): Accounting Psychology, Minor(s): Statistics 
Group 140:
	Ariana Zelake - Email: azelakefn@etsy.com, Section 5, Major(s): Communication Studies , Minor(s): Biology 
	Kippie Kail - Email: kkailj3@ox.ac.uk, Section 5, Major(s): Biology , Minor(s): Accounting 
	Arlen Traice - Email: atraice9j@webnode.com, Section 5, Major(s): African American Studies Women & Gender Studies
Group 141:
	Orren Pickup - Email: opickup8n@alexa.com, Section 5, Major(s): Accounting Psychology, Minor(s): Statistics 
	Eartha Vint - Email: evintod@earthlink.net, Section 5, Major(s): Finance 
	Jaquelyn Espadater - Email: jespadaterkv@ucsd.edu, Section 5, Major(s): Chemistry Women & Gender Studies, Minor(s): Anthropology 
Group 142:
	Murry Massinger - Email: mmassingerh3@prlog.org, Section 5, Major(s): Music Mathematics, Minor(s): Interdisciplinary Studies 
	Reuben Trubshawe - Email: rtrubshaweg@multiply.com, Section 5, Major(s): History 
	Ogdon Wilbud - Email: owilbud9p@spotify.com, Section 5, Major(s): Communication Studies , Minor(s): Biology 
Group 143:
	Leonie Riping - Email: lripinghz@quantcast.com, Section 5, Major(s): Communication Studies , Minor(s): Biology Accounting
	Rollin Blackborow - Email: rblackborow2r@hp.com, Section 5, Major(s): Biomedical Engineering , Minor(s): Accounting 
Group 144:
	Stephen Fulbrook - Email: sfulbrookjd@parallels.com, Section 8, Major(s): Mathematics , Minor(s): Interdisciplinary Studies 
	Fraser Tubritt - Email: ftubrittav@mac.com, Section 8, Major(s): Journalism 
	Kaitlynn Zupone - Email: kzupone54@java.com, Section 8, Major(s): Statistics 
Group 145:
	Saree Buncom - Email: sbuncomoo@spiegel.de, Section 8, Major(s): Mathematics , Minor(s): Interactive Mulitmedia 
	Norrie Alcorn - Email: nalcorndk@hao123.com, Section 8, Major(s): Nursing , Minor(s): Journalism 
	Shirlee Ullett - Email: sullett37@delicious.com, Section 8, Major(s): Music 
Group 146:
	Peggi Wolfer - Email: pwolferfx@rakuten.co.jp, Section 8, Major(s): Music , Minor(s): Journalism 
	Ulises Winston - Email: uwinstonc@simplemachines.org, Section 8, Major(s): Electrical Engineering 
	Tabby Allabarton - Email: tallabarton7j@si.edu, Section 8, Major(s): Nursing , Minor(s): Journalism 
Group 147:
	Magnum Becken - Email: mbeckeno0@umn.edu, Section 8, Major(s): Mathematics , Minor(s): Interactive Mulitmedia 
	Carolin Tankus - Email: ctankusiu@infoseek.co.jp, Section 8, Major(s): Music 
	Anthia Traviss - Email: atravisser@liveinternet.ru, Section 8, Major(s): Music 
Group 148:
	Berte Barbara - Email: bbarbarann@time.com, Section 8, Major(s): Mathematics , Minor(s): Interactive Mulitmedia Health & Exercise Science
	Lilian Bilson - Email: lbilsonhn@imageshack.us, Section 8, Major(s): Mechanical Engineering 
	Ariadne Angood - Email: aangoodeq@netlog.com, Section 8, Major(s): Mechanical Engineering 
Group 149:
	Stephanus Greer - Email: sgreergg@ebay.co.uk, Section 8, Major(s): Mathematics , Minor(s): Interdisciplinary Studies 
	Ossie Walisiak - Email: owalisiakm5@yahoo.co.jp, Section 8, Major(s): Statistics 
	Caesar Aldwich - Email: caldwich43@java.com, Section 8, Major(s): Nursing , Minor(s): Journalism 
Group 150:
	Erroll Benton - Email: ebentonkj@psu.edu, Section 8, Major(s): Mathematics , Minor(s): Interactive Mulitmedia 
	Rania Wilbraham - Email: rwilbrahamr8@cornell.edu, Section 8, Major(s): Journalism 
	Gardy Bembridge - Email: gbembridgejz@yandex.ru, Section 8, Major(s): Mechanical Engineering 
Group 151:
	Cello Faulds - Email: cfauldscm@columbia.edu, Section 8, Major(s): Mathematics , Minor(s): Interdisciplinary Studies 
	Gayle Bartolomucci - Email: gbartolomuccia4@adobe.com, Section 8, Major(s): Nursing 
	Davina Wilfling - Email: dwilflingcl@spiegel.de, Section 8, Major(s): Journalism , Minor(s): Health & Exercise Science 
Group 152:
	Zsa zsa Wentworth - Email: zwentworth7i@homestead.com, Section 8, Major(s): Music , Minor(s): Journalism 
	Nev Beavis - Email: nbeavis2a@sphinn.com, Section 8, Major(s): Mathematics , Minor(s): Interactive Mulitmedia 
	Daphna Arnow - Email: darnowep@about.me, Section 8, Major(s): Mathematics , Minor(s): Interactive Mulitmedia Health & Exercise Science
Group 153:
	Town Watson-Brown - Email: twatsonbrownp4@webnode.com, Section 8, Major(s): Mathematics , Minor(s): Journalism 
	Taddeo Tumayan - Email: ttumayanhd@aol.com, Section 8, Major(s): Chemistry 
	Cassie Zorener - Email: czorenerrb@europa.eu, Section 8, Major(s): Journalism , Minor(s): Health & Exercise Science 
Group 154:
	Clemmie Dyte - Email: cdytemt@goo.ne.jp, Section 8, Major(s): Mathematics 
	Darcy Wishart - Email: dwishartho@trellian.com, Section 8, Major(s): Music , Minor(s): Journalism 
	Innis Genicke - Email: igenicke6l@census.gov, Section 8, Major(s): Mathematics , Minor(s): Interdisciplinary Studies 
Group 155:
	Ware Winthrop - Email: wwinthrop4v@geocities.com, Section 8, Major(s): Mathematics , Minor(s): Journalism 
	Dew Hassewell - Email: dhassewell7g@cdc.gov, Section 8, Major(s): Mathematics , Minor(s): Interdisciplinary Studies 
	Jehu Dugan - Email: jdugana1@slideshare.net, Section 8, Major(s): Mathematics 
Group 156:
	Marieann Yukhnov - Email: myukhnovaw@slashdot.org, Section 8, Major(s): Mathematics , Minor(s): Journalism 
	Consuelo Vardy - Email: cvardyi7@squidoo.com, Section 8, Major(s): Mathematics , Minor(s): Journalism 
	Loraine Busch - Email: lbuschme@cnbc.com, Section 8, Major(s): Mathematics , Minor(s): Health & Exercise Science 
Group 157:
	Derwin Slaney - Email: dslaneyog@salon.com, Section 8, Major(s): Mathematics 
	Fairlie Brudenell - Email: fbrudenellfv@aboutads.info, Section 8, Major(s): Mathematics , Minor(s): Interactive Mulitmedia 
	Aindrea Boyan - Email: aboyan8b@theguardian.com, Section 8, Major(s): Mathematics , Minor(s): Interactive Mulitmedia 
Group 158:
	Burton Clausner - Email: bclausneris@tripod.com, Section 8, Major(s): Mathematics 
	Artair Cicetti - Email: acicetti40@de.vu, Section 8, Major(s): Mathematics , Minor(s): Health & Exercise Science 
	Bernelle Grishmanov - Email: bgrishmanovbr@hc360.com, Section 8, Major(s): Mathematics , Minor(s): Interdisciplinary Studies 
Group 159:
	Nicholas Tuison - Email: ntuisonhm@google.com.br, Section 8, Major(s): Mathematics 
Group 160:
	Catherina Reuss - Email: creuss4b@topsy.com, Section 7, Major(s): Economics , Minor(s): Computer Science 
	Dela Thying - Email: dthyingh0@liveinternet.ru, Section 7, Major(s): Journalism , Minor(s): Health & Exercise Science 
	Collette Drinkeld - Email: cdrinkeld7a@amazon.com, Section 7, Major(s): Finance 
Group 161:
	Caron Antonetti - Email: cantonetti3w@yellowpages.com, Section 7, Major(s): History 
	Bryon Seven - Email: bsevengp@google.co.jp, Section 7, Major(s): Economics , Minor(s): Computer Science 
	Rance Gallo - Email: rgallolw@usnews.com, Section 7, Major(s): Finance , Minor(s): Computer Science 
Group 162:
	Toma Pendlebery - Email: tpendleberyhv@dailymail.co.uk, Section 7, Major(s): Economics , Minor(s): Computer Science 
	Sol Lorenc - Email: slorenc32@spotify.com, Section 7, Major(s): Interactive Mulitmedia , Minor(s): English 
	Sarina Domokos - Email: sdomokosiq@tinypic.com, Section 7, Major(s): History , Minor(s): Criminology 
Group 163:
	Dill Hardey - Email: dhardeybo@nba.com, Section 7, Major(s): Interactive Mulitmedia , Minor(s): English 
	Cassaundra Novkovic - Email: cnovkovicv@clickbank.net, Section 7, Major(s): Economics , Minor(s): Computer Science 
	Aidan Burdoun - Email: aburdoun33@facebook.com, Section 7, Major(s): Interdisciplinary Studies 
Group 164:
	Courtenay Fann - Email: cfannp1@google.com.hk, Section 7, Major(s): Finance 
	Cherie Skirvane - Email: cskirvane27@devhub.com, Section 7, Major(s): Interactive Mulitmedia 
	Betti Trengrouse - Email: btrengrouseqw@wordpress.org, Section 7, Major(s): Journalism , Minor(s): Health & Exercise Science 
Group 165:
	Blinny Wadlow - Email: bwadlowmb@flavors.me, Section 7, Major(s): Finance 
	Silvanus Cockerill - Email: scockerillrr@tamu.edu, Section 7, Major(s): History , Minor(s): Criminology 
	Devina Gringley - Email: dgringleyau@imageshack.us, Section 7, Major(s): Interdisciplinary Studies , Minor(s): Finance 
Group 166:
	Feodor Easum - Email: feasumaq@fema.gov, Section 7, Major(s): Finance 
	Kyrstin Chanson - Email: kchanson5m@un.org, Section 7, Major(s): History , Minor(s): Criminology 
	Kanya Jordin - Email: kjordin6i@360.cn, Section 7, Major(s): Interactive Mulitmedia , Minor(s): English 
Group 167:
	Jarrad Christou - Email: jchristou9x@wikispaces.com, Section 7, Major(s): History , Minor(s): Criminology 
	Kilian Cristou - Email: kcristoui4@biblegateway.com, Section 7, Major(s): Finance , Minor(s): Computer Science 
	Carmon Masurel - Email: cmasurelcj@ocn.ne.jp, Section 7, Major(s): Interactive Mulitmedia , Minor(s): English 
Group 168:
	Leonore Dunridge - Email: ldunridge2x@hao123.com, Section 7, Major(s): Electrical Engineering 
	Aida Gomersall - Email: agomersallmq@youku.com, Section 7, Major(s): Finance , Minor(s): Computer Science 
	Geoffry Heaford - Email: gheaforde@paginegialle.it, Section 7, Major(s): Finance , Minor(s): Computer Science 
Group 169:
	Chandler Yeo - Email: cyeo4s@senate.gov, Section 7, Major(s): Interactive Mulitmedia 
	Dacy Roselli - Email: droselli8m@seattletimes.com, Section 7, Major(s): Economics , Minor(s): Computer Science 
	Ethelin Carrabott - Email: ecarrabottce@paypal.com, Section 7, Major(s): Electrical Engineering , Minor(s): Computer Science 
Group 170:
	Emlyn Sirett - Email: esirett9h@bloomberg.com, Section 7, Major(s): Economics , Minor(s): Computer Science 
	Natal Chue - Email: nchuenx@desdev.cn, Section 7, Major(s): Finance , Minor(s): Computer Science 
	Reynolds Dominici - Email: rdominici9v@flickr.com, Section 7, Major(s): Finance 
Group 171:
	Lynnell Carik - Email: lcariken@photobucket.com, Section 7, Major(s): History , Minor(s): Criminology 
	Marty Coldbath - Email: mcoldbath4t@symantec.com, Section 7, Major(s): Interdisciplinary Studies 
	Tabbi Terzi - Email: tterzij1@sina.com.cn, Section 7, Major(s): Economics 
Group 172:
	Bernadette Franzewitch - Email: bfranzewitch7e@baidu.com, Section 7, Major(s): Interdisciplinary Studies 
	Karia Dingsdale - Email: kdingsdalen6@posterous.com, Section 7, Major(s): History , Minor(s): Criminology 
	Sharl Corneille - Email: scorneillekg@sina.com.cn, Section 7, Major(s): Finance , Minor(s): Computer Science 
Group 173:
	Veradis Egle - Email: vegle1d@technorati.com, Section 7, Major(s): Interdisciplinary Studies 
	Stanford Cockerill - Email: scockerill26@biblegateway.com, Section 7, Major(s): History , Minor(s): Criminology 
	Tony Knowlden - Email: tknowldenac@dmoz.org, Section 7, Major(s): Economics , Minor(s): Computer Science 
Group 174:
	Greer Laity - Email: glaity5n@xinhuanet.com, Section 7, Major(s): Interactive Mulitmedia , Minor(s): English 
	Branden Tschirasche - Email: btschiraschedy@bandcamp.com, Section 7, Major(s): Computer Science 
	Kaleb Biggar - Email: kbiggar94@yellowbook.com, Section 7, Major(s): Interdisciplinary Studies , Minor(s): English 
Group 175:
	Gilbertine Chidgey - Email: gchidgeyl2@weibo.com, Section 7, Major(s): History , Minor(s): Criminology 
	Bartolomeo Goddert.sf - Email: bgoddertsfck@behance.net, Section 7, Major(s): Interdisciplinary Studies , Minor(s): Finance 
	Adlai Navein - Email: anavein3x@aol.com, Section 7, Major(s): Interactive Mulitmedia 
Group 176:
	Ives Cyson - Email: icysone1@army.mil, Section 7, Major(s): Finance , Minor(s): Computer Science 
	Shelly Stodit - Email: sstodited@dion.ne.jp, Section 7, Major(s): Economics 
	Lacie Milton - Email: lmilton1c@jimdo.com, Section 7, Major(s): Interactive Mulitmedia , Minor(s): English 
Group 177:
	Carolyne Zorzoni - Email: czorzoni1p@indiegogo.com, Section 7, Major(s): Women & Gender Studies 
	Letta Ciccoloi - Email: lciccoloiom@mail.ru, Section 7, Major(s): History , Minor(s): Criminology 
	Zedekiah Filby - Email: zfilbygy@ucla.edu, Section 7, Major(s): Finance 
Group 178:
	Yancy Ellsom - Email: yellsomh@virginia.edu, Section 7, Major(s): Interactive Mulitmedia , Minor(s): English 
	Cherilynn Torbard - Email: ctorbardds@e-recht24.de, Section 7, Major(s): Economics 
	Jolyn L'Hommeau - Email: jlhommeau56@hexun.com, Section 7, Major(s): Economics , Minor(s): Computer Science 
Group 179:
	Rebbecca Stryde - Email: rstrydede@businesswire.com, Section 7, Major(s): Interactive Mulitmedia 
	Susanetta Conyer - Email: sconyer24@stumbleupon.com, Section 7, Major(s): Finance , Minor(s): Computer Science 
	Jesselyn Aleavy - Email: jaleavy6h@hostgator.com, Section 7, Major(s): History 
Group 180:
	Alexei Dannell - Email: adannellnk@w3.org, Section 7, Major(s): Finance 
	Claiborn Di Biasi - Email: cdibiasii@scribd.com, Section 7, Major(s): Interdisciplinary Studies 
	Samuele Torrecilla - Email: storrecilla88@slashdot.org, Section 7, Major(s): Interactive Mulitmedia 
Group 181:
	Demeter Nibley - Email: dnibley9y@jigsy.com, Section 7, Major(s): Interactive Mulitmedia 
	Anni Grigoire - Email: agrigoire9z@huffingtonpost.com, Section 7, Major(s): Interdisciplinary Studies , Minor(s): Finance 
	Salomi Stokell - Email: sstokell0@addthis.com, Section 7, Major(s): Economics 
Group 182:
	Tildie Odegaard - Email: todegaardk7@gmpg.org, Section 7, Major(s): Economics , Minor(s): Computer Science 
	Marv Wimmers - Email: mwimmersql@posterous.com, Section 7, Major(s): Computer Science 
	Leola Franchyonok - Email: lfranchyonokol@cam.ac.uk, Section 7, Major(s): Finance , Minor(s): Computer Science 
Group 183:
	Olive Teresa - Email: oteresa93@dropbox.com, Section 7, Major(s): Interactive Mulitmedia 
	Shandy Whetnell - Email: swhetnelljm@irs.gov, Section 7, Major(s): Economics 
	Grayce Talbot - Email: gtalbotqx@patch.com, Section 7, Major(s): Journalism , Minor(s): Health & Exercise Science 
Group 184:
	Kerry Morrissey - Email: kmorrisseyat@hubpages.com, Section 7, Major(s): Interactive Mulitmedia , Minor(s): English 
Group 185:
	Stanfield Paul - Email: spaulbb@storify.com, Section 11, Major(s): Art History , Minor(s): Women & Gender Studies 
	Archibold Broschke - Email: abroschke4m@altervista.org, Section 11, Major(s): Criminology 
	Sara Broomhall - Email: sbroomhallfw@geocities.jp, Section 11, Major(s): Mechanical Engineering 
Group 186:
	Chet Pomery - Email: cpomery3@squarespace.com, Section 11, Major(s): Anthropology , Minor(s): Sociology 
	Dewain Bramont - Email: dbramont9s@slashdot.org, Section 11, Major(s): Criminology 
	Jaquenetta Lesek - Email: jlesek5@who.int, Section 11, Major(s): Biology 
Group 187:
	Shaine Butterfield - Email: sbutterfield1g@marketwatch.com, Section 11, Major(s): Mechanical Engineering 
	Wendy Arrault - Email: warraultaa@chronoengine.com, Section 11, Major(s): Statistics 
	Marcy Boldison - Email: mboldisonkn@w3.org, Section 11, Major(s): Physics 
Group 188:
	Haslett Bruckenthal - Email: hbruckenthalbm@plala.or.jp, Section 11, Major(s): Health & Exercise Science 
	Angel Barrable - Email: abarrablerh@businesswire.com, Section 11, Major(s): Statistics 
	Harrietta Andreasson - Email: handreasson7d@soundcloud.com, Section 11, Major(s): Interactive Mulitmedia 
Group 189:
	Jerrine Blunsum - Email: jblunsumf@wp.com, Section 11, Major(s): Health & Exercise Science 
	Karel Antczak - Email: kantczakco@opensource.org, Section 11, Major(s): Music 
	Vonnie Bett - Email: vbettbv@edublogs.org, Section 11, Major(s): Philiosophy 
Group 190:
	Xenia Lowther - Email: xlowtherf0@digg.com, Section 11, Major(s): Biology , Minor(s): Statistics 
	Genna Bernardet - Email: gbernardetp0@cornell.edu, Section 11, Major(s): Criminology 
	Carma Antosik - Email: cantosik9c@ameblo.jp, Section 11, Major(s): Political Science 
Group 191:
	Evin Beiderbeck - Email: ebeiderbeckmv@t-online.de, Section 11, Major(s): Philiosophy 
	Guillema Byllam - Email: gbyllam3v@baidu.com, Section 11, Major(s): Health & Exercise Science 
	Wildon Lindenstrauss - Email: wlindenstraussk9@free.fr, Section 11, Major(s): Biology 
Group 192:
	Rina Bourthouloume - Email: rbourthouloume8@washingtonpost.com, Section 11, Major(s): Communication Studies 
	Ricardo Caldaro - Email: rcaldaro5t@macromedia.com, Section 11, Major(s): Nursing 
	Olva Lazonby - Email: olazonbyhx@amazon.com, Section 11, Major(s): Biology 
Group 193:
	Natalina Burberow - Email: nburberowln@mail.ru, Section 11, Major(s): Physics 
	Nelie Andreoletti - Email: nandreolettia5@amazonaws.com, Section 11, Major(s): Philiosophy 
	Mordy Kordovani - Email: mkordovanig6@shareasale.com, Section 11, Major(s): Biology 
Group 194:
	Kissiah Burleigh - Email: kburleighnb@craigslist.org, Section 11, Major(s): Physics 
	Kellen MacAirt - Email: kmacairt8l@usa.gov, Section 11, Major(s): Women & Gender Studies , Minor(s): Sociology 
	Margi Boog - Email: mboogke@php.net, Section 11, Major(s): Criminology 
Group 195:
	Jorie Penburton - Email: jpenburtonaf@uiuc.edu, Section 11, Major(s): Anthropology , Minor(s): Sociology 
	Connor Barnwell - Email: cbarnwell6q@ucsd.edu, Section 11, Major(s): Physics 
	Darice Pyburn - Email: dpyburn2p@techcrunch.com, Section 11, Major(s): Art History , Minor(s): Women & Gender Studies 
Group 196:
	Sarajane Bullerwell - Email: sbullerwell50@yandex.ru, Section 11, Major(s): Physics 
	Rodd Attkins - Email: rattkins8x@about.com, Section 11, Major(s): Criminology 
	Neville Wollacott - Email: nwollacott4e@chronoengine.com, Section 11, Major(s): Anthropology , Minor(s): Statistics 
Group 197:
	Mirabel Bendall - Email: mbendallfy@nationalgeographic.com, Section 11, Major(s): Philiosophy 
	Lance Blaksley - Email: lblaksley3k@businesswire.com, Section 11, Major(s): Art History , Minor(s): Statistics 
	Martita Malloy - Email: mmalloyhu@webeden.co.uk, Section 11, Major(s): Women & Gender Studies , Minor(s): Sociology 
Group 198:
	Ced Bortoli - Email: cbortolign@infoseek.co.jp, Section 11, Major(s): Statistics 
	Vic Calam - Email: vcalammo@wikia.com, Section 11, Major(s): Computer Science 
	Halie Crossley - Email: hcrossley9l@webmd.com, Section 11, Major(s): Art History 
Group 199:
	Marlo MacCorley - Email: mmaccorley4g@virginia.edu, Section 11, Major(s): Biology , Minor(s): Statistics 
	Cornelia Tindle - Email: ctindled1@google.com.br, Section 11, Major(s): Art History , Minor(s): Women & Gender Studies 
	Siward Kleingrub - Email: skleingrub5a@ucoz.ru, Section 11, Major(s): Art History , Minor(s): Women & Gender Studies Statistics
Group 200:
	Abba Saffer - Email: asaffer7u@behance.net, Section 11, Major(s): Anthropology , Minor(s): Sociology 
	Inesita Brixey - Email: ibrixeyaz@yahoo.com, Section 11, Major(s): Nursing 
	Lorelei Antunez - Email: lantunezq@nature.com, Section 11, Major(s): Political Science 
Group 201:
	Kariotta Christoffersen - Email: kchristoffersenz@usda.gov, Section 11, Major(s): Art History , Minor(s): Statistics 
	Thoma Berrecloth - Email: tberreclotha3@github.com, Section 11, Major(s): Music 
	Niven Birks - Email: nbirks5h@google.de, Section 11, Major(s): Criminology 
Group 202:
	Charmian Barden - Email: cbardenb4@wordpress.org, Section 11, Major(s): Sociology 
	Kipp Reinhard - Email: kreinhardag@soup.io, Section 11, Major(s): Art History , Minor(s): Women & Gender Studies 
	Carolyn Bertson - Email: cbertson8h@studiopress.com, Section 11, Major(s): Political Science 
Group 203:
	Bobine Hotton - Email: bhotton2k@weibo.com, Section 11, Major(s): Women & Gender Studies , Minor(s): Sociology 
	Pamella Merrett - Email: pmerrett4f@npr.org, Section 11, Major(s): Art History , Minor(s): Women & Gender Studies 
	Bart Vallentin - Email: bvallentincn@nasa.gov, Section 11, Major(s): Mechanical Engineering 
Group 204:
	Mack Weatherill - Email: mweatherillax@telegraph.co.uk, Section 11, Major(s): Mechanical Engineering 
	Leanora Maddaford - Email: lmaddafordef@infoseek.co.jp, Section 11, Major(s): Biology , Minor(s): Statistics 
	Harmon Matiasek - Email: hmatiasek8r@dropbox.com, Section 11, Major(s): Biology , Minor(s): Women & Gender Studies 
Group 205:
	Javier Mackley - Email: jmackleyh9@patch.com, Section 11, Major(s): Women & Gender Studies , Minor(s): Sociology 
	Carly Woolhouse - Email: cwoolhouse2i@techcrunch.com, Section 11, Major(s): Sociology 
	Judie Corde - Email: jcorde7v@rambler.ru, Section 11, Major(s): Art History , Minor(s): Statistics 
Group 206:
	Chrissie Birney - Email: cbirneyh4@lulu.com, Section 11, Major(s): Philiosophy 
	Geoff Boncore - Email: gboncoren4@nih.gov, Section 11, Major(s): Criminology 
	Gerianne Peatheyjohns - Email: gpeatheyjohnsba@liveinternet.ru, Section 11, Major(s): Anthropology , Minor(s): Sociology 
Group 207:
	Umberto Bellhouse - Email: ubellhouseda@nationalgeographic.com, Section 11, Major(s): English 
	Jordain Alldis - Email: jalldis1j@elpais.com, Section 11, Major(s): Philiosophy 
	Gale Broxis - Email: gbroxisf5@theguardian.com, Section 11, Major(s): Criminology 
Group 208:
	Lissie Borg - Email: lborgni@blogs.com, Section 2, Major(s): Computer Science Communication Studies, Minor(s): Art History 
	Hephzibah Swayland - Email: hswayland2u@xrea.com, Section 2, Major(s): Computer Engineering Chemistry
	Corrie Taffrey - Email: ctaffrey4k@webeden.co.uk, Section 2, Major(s): Computer Engineering Chemistry
Group 209:
	Donnie Lathy - Email: dlathyp8@zdnet.com, Section 2, Major(s): Criminology Communication Studies
	Debora Barten - Email: dbartenq9@ted.com, Section 2, Major(s): Computer Science Communication Studies, Minor(s): Art History 
	Katusha Scotland - Email: kscotlandoe@apache.org, Section 2, Major(s): History 
Group 210:
	Charlotte Bernaciak - Email: cbernaciakqj@meetup.com, Section 2, Major(s): Computer Science Communication Studies, Minor(s): Art History 
	Natty Rycroft - Email: nrycroftlz@mlb.com, Section 2, Major(s): Mathematics 
	Gorden Renzullo - Email: grenzullo4h@fastcompany.com, Section 2, Major(s): Biomedical Engineering 
Group 211:
	Shem Wegenen - Email: swegenen75@weibo.com, Section 2, Major(s): Computer Engineering Communication Studies
	Ronni Sellars - Email: rsellarsfh@ca.gov, Section 2, Major(s): Statistics 
	Flin Wantling - Email: fwantlingjr@blogspot.com, Section 2, Major(s): Computer Engineering Communication Studies
Group 212:
	Cassie Savage - Email: csavage5s@moonfruit.com, Section 2, Major(s): Music 
	Marylin Buncombe - Email: mbuncombepi@accuweather.com, Section 2, Major(s): Computer Science Communication Studies, Minor(s): Art History 
	Nicolai Avraham - Email: navrahamq4@nytimes.com, Section 2, Major(s): Computer Science Communication Studies
Group 213:
	Tarra Rosas - Email: trosas96@ebay.co.uk, Section 2, Major(s): Mathematics 
	Ricardo Sabine - Email: rsabine72@fotki.com, Section 2, Major(s): Biomedical Engineering 
	Bartie Bert - Email: bberta@hubpages.com, Section 2, Major(s): Computer Science Communication Studies, Minor(s): Art History 
Group 214:
	Abagail Gricewood - Email: agricewood6c@pen.io, Section 2, Major(s): Criminology Communication Studies
	Shepard Reeme - Email: sreeme35@sciencedirect.com, Section 2, Major(s): Mathematics 
	Kean Ratchford - Email: kratchfordpc@fda.gov, Section 2, Major(s): Mathematics 
Group 215:
	Angelia Jays - Email: ajaysdx@examiner.com, Section 2, Major(s): Computer Engineering Chemistry, Minor(s): Anthropology 
	Erny Gatiss - Email: egatissil@eepurl.com, Section 2, Major(s): Computer Engineering Chemistry, Minor(s): African American Studies 
	Doria Deeming - Email: ddeeming3p@163.com, Section 2, Major(s): Computer Engineering Chemistry
Group 216:
	Melania Rosone - Email: mrosonek2@mayoclinic.com, Section 2, Major(s): Physics 
	Brinn Salmon - Email: bsalmonrk@deviantart.com, Section 2, Major(s): History 
	Chrystal Skakunas - Email: cskakunas73@blogtalkradio.com, Section 2, Major(s): Chemistry Biology, Minor(s): Art History 
Group 217:
	Colas Theis - Email: ctheisal@eventbrite.com, Section 2, Major(s): Computer Engineering Communication Studies
	Hillier Dan - Email: hdanj6@wikia.com, Section 2, Major(s): Computer Engineering Chemistry
	Deedee Rikard - Email: drikard91@multiply.com, Section 2, Major(s): Health & Exercise Science 
Group 218:
	Damiano Presho - Email: dpresho5r@bbc.co.uk, Section 2, Major(s): Mechanical Engineering 
	Onfroi Hawkswell - Email: ohawkswellei@tripadvisor.com, Section 2, Major(s): Computer Engineering Chemistry, Minor(s): Anthropology 
	Cam Barttrum - Email: cbarttrump7@oakley.com, Section 2, Major(s): Computer Science Communication Studies, Minor(s): Art History 
Group 219:
	Meagan Preddle - Email: mpreddlej8@umich.edu, Section 2, Major(s): Criminology 
	Crawford Riggs - Email: criggsjb@networkadvertising.org, Section 2, Major(s): History 
	Loren Rankin - Email: lrankindd@parallels.com, Section 2, Major(s): History 
Group 220:
	Joeann Riggoll - Email: jriggolll@ustream.tv, Section 2, Major(s): Mechanical Engineering 
	Lynett Sackett - Email: lsackettmn@cnbc.com, Section 2, Major(s): Chemistry 
	Vachel Benedit - Email: vbeneditim@upenn.edu, Section 2, Major(s): Computer Science Communication Studies, Minor(s): Art History 
Group 221:
	Alphard Scarlett - Email: ascarlettex@bbb.org, Section 2, Major(s): Women & Gender Studies 
	Erv Queste - Email: equesteb2@nbcnews.com, Section 2, Major(s): Political Science 
	Murry Walcot - Email: mwalcotcb@whitehouse.gov, Section 2, Major(s): Computer Engineering Communication Studies
Group 222:
	Eleanor Shirrell - Email: eshirrellle@fda.gov, Section 2, Major(s): Chemistry Biology, Minor(s): Art History 
	Raina Caffrey - Email: rcaffreypo@discuz.net, Section 2, Major(s): Computer Science Communication Studies, Minor(s): Art History 
	Quinta Ragles - Email: qraglesar@usgs.gov, Section 2, Major(s): Health & Exercise Science 
Group 223:
	Jerome Radclyffe - Email: jradclyffebg@desdev.cn, Section 2, Major(s): Computer Engineering 
	Nari Heigl - Email: nheiglfq@webmd.com, Section 2, Major(s): Criminology Communication Studies
	Ainslee Gravet - Email: agravetlv@4shared.com, Section 2, Major(s): Criminology Communication Studies
Group 224:
	Gale Brinkler - Email: gbrinklerfo@time.com, Section 2, Major(s): Computer Engineering Chemistry
	Jamil Salisbury - Email: jsalisburygb@pinterest.com, Section 2, Major(s): Criminology 
	Erna Bridgen - Email: ebridgeni1@nyu.edu, Section 2, Major(s): Computer Science Communication Studies, Minor(s): Art History 
Group 225:
	Atalanta Ramsey - Email: aramseydf@phpbb.com, Section 2, Major(s): Interdisciplinary Studies 
	Norene Rosenbaum - Email: nrosenbaummp@un.org, Section 2, Major(s): Criminology 
	Brittni Rodie - Email: brodie19@phpbb.com, Section 2, Major(s): Finance 
Group 226:
	Berne Sorby - Email: bsorby9@wisc.edu, Section 2, Major(s): Computer Engineering Chemistry
	Henriette Dovydenas - Email: hdovydenasd6@indiegogo.com, Section 2, Major(s): Computer Engineering Chemistry
	Carla Dunkinson - Email: cdunkinson9q@cbc.ca, Section 2, Major(s): Computer Engineering Chemistry
Group 227:
	Kerrill Kas - Email: kkas6a@bbb.org, Section 2, Major(s): Computer Engineering Chemistry, Minor(s): Anthropology 
	Lizzie Ryhorovich - Email: lryhorovichmh@vistaprint.com, Section 2, Major(s): Physics 
	Emma Ridout - Email: eridoutm2@vk.com, Section 2, Major(s): Physics 
Group 228:
	Pedro Baldelli - Email: pbaldelliqm@webmd.com, Section 2, Major(s): Computer Science Communication Studies
	Charlotta Alliband - Email: calliband14@stanford.edu, Section 2, Major(s): Computer Engineering Chemistry, Minor(s): Biology 
	Wilhelm Aronsohn - Email: waronsohnpp@umich.edu, Section 2, Major(s): Computer Science Communication Studies
Group 229:
	Abie Golsworthy - Email: agolsworthyd8@nih.gov, Section 2, Major(s): Criminology Communication Studies
	Aryn Breens - Email: abreenskx@washington.edu, Section 2, Major(s): Computer Engineering Chemistry, Minor(s): Biology 
	Celka Blackaller - Email: cblackaller5f@wired.com, Section 2, Major(s): Computer Engineering Chemistry, Minor(s): Biology 
Group 230:
	Renelle Ratt - Email: rratt1f@hao123.com, Section 2, Major(s): Mathematics 
	Angeli Trorey - Email: atroreygu@intel.com, Section 2, Major(s): Computer Engineering Communication Studies
Group 231:
	Fayth Guwer - Email: fguwer5e@wordpress.com, Section 6, Major(s): Communication Studies , Minor(s): Biomedical Engineering 
	Blinnie Spur - Email: bspurqk@ebay.co.uk, Section 6, Major(s): Computer Science , Minor(s): Chemistry 
	Cicily Zohrer - Email: czohrerlh@qq.com, Section 6, Major(s): Finance 
Group 232:
	Sabra Roder - Email: sroderbh@parallels.com, Section 6, Major(s): Computer Science 
	Karia Trudgeon - Email: ktrudgeonmw@yelp.com, Section 6, Major(s): Physics 
	Peyter Jarnell - Email: pjarnell74@ebay.co.uk, Section 6, Major(s): Communication Studies , Minor(s): Biomedical Engineering 
Group 233:
	Aindrea Norbury - Email: anorburyq0@ifeng.com, Section 6, Major(s): Computer Science 
	Bonni Hanrahan - Email: bhanrahanik@printfriendly.com, Section 6, Major(s): Communication Studies , Minor(s): Biomedical Engineering 
	Tod Ganforthe - Email: tganforthed5@about.com, Section 6, Major(s): Communication Studies , Minor(s): Biomedical Engineering 
Group 234:
	Bella Birtonshaw - Email: bbirtonshaw6d@storify.com, Section 6, Major(s): Electrical Engineering , Minor(s): Computer Science 
	Iver Popescu - Email: ipopescuhg@cyberchimps.com, Section 6, Major(s): Computer Science 
	Etheline Parlott - Email: eparlottga@list-manage.com, Section 6, Major(s): Computer Science 
Group 235:
	Brigitte McKeady - Email: bmckeadyam@sakura.ne.jp, Section 6, Major(s): Computer Science , Minor(s): Chemistry 
	Kari Kneel - Email: kkneelgt@hibu.com, Section 6, Major(s): Communication Studies , Minor(s): Biomedical Engineering 
	Tess Gard - Email: tgard4j@ustream.tv, Section 6, Major(s): Communication Studies , Minor(s): Biomedical Engineering 
Group 236:
	Martino Rean - Email: mreanq1@delicious.com, Section 6, Major(s): Computer Science 
	Anneliese Ivanonko - Email: aivanonkoak@skype.com, Section 6, Major(s): Communication Studies , Minor(s): Biomedical Engineering 
	Emlyn Gellert - Email: egellert69@google.cn, Section 6, Major(s): Communication Studies , Minor(s): Biomedical Engineering 
Group 237:
	Catlee Stile - Email: cstileqt@alibaba.com, Section 6, Major(s): Computer Science , Minor(s): Communication Studies 
	Jordon Hawker - Email: jhawkerkb@over-blog.com, Section 6, Major(s): Communication Studies , Minor(s): Biomedical Engineering 
	Friedrick Ellerington - Email: felleringtonf2@toplist.cz, Section 6, Major(s): Communication Studies , Minor(s): Biomedical Engineering 
Group 238:
	Casper Shirtcliffe - Email: cshirtcliffe8w@reddit.com, Section 6, Major(s): Computer Science , Minor(s): Chemistry 
	Shayla Vorley - Email: svorley49@myspace.com, Section 6, Major(s): Statistics 
	Marjory Nesbit - Email: mnesbitps@spiegel.de, Section 6, Major(s): Computer Science 
Group 239:
	Worth Lewisham - Email: wlewishamlf@ning.com, Section 6, Major(s): Computer Science 
	Susanne O'Lagen - Email: solagenpx@soundcloud.com, Section 6, Major(s): Computer Science 
	Barde Skeene - Email: bskeeneqe@csmonitor.com, Section 6, Major(s): Computer Science , Minor(s): Chemistry 
Group 240:
	Rowland Mosey - Email: rmoseypy@newsvine.com, Section 6, Major(s): Computer Science , Minor(s): Chemistry 
	Sheppard Quirke - Email: squirkepg@boston.com, Section 6, Major(s): Computer Science 
	Jany Gianolini - Email: jgianolini76@techcrunch.com, Section 6, Major(s): Computer Science , Minor(s): Communication Studies Biology
Group 241:
	Mikkel Miskin - Email: mmiskinq8@cornell.edu, Section 6, Major(s): Computer Science , Minor(s): Chemistry 
	Che Sale - Email: csaleqb@ezinearticles.com, Section 6, Major(s): Computer Science 
	Fionna McMahon - Email: fmcmahon9r@baidu.com, Section 6, Major(s): Computer Science , Minor(s): Chemistry 
Group 242:
	Chiarra Swyer-Sexey - Email: cswyersexeypt@tmall.com, Section 6, Major(s): Computer Science , Minor(s): Communication Studies 
	Jack Logue - Email: jlogue2v@clickbank.net, Section 6, Major(s): Computer Science 
	Bartholomeo Rief - Email: briefq5@marriott.com, Section 6, Major(s): Computer Science 
Group 243:
	Heloise Sherme - Email: hshermepv@apple.com, Section 6, Major(s): Computer Science , Minor(s): Chemistry 
	Lothario Lindstrom - Email: llindstromgv@wikipedia.org, Section 6, Major(s): Computer Science 
	Jordon Pierrepont - Email: jpierrepontqh@usnews.com, Section 6, Major(s): Computer Science 
Group 244:
	Marcela Langworthy - Email: mlangworthyqc@mozilla.org, Section 6, Major(s): Computer Science , Minor(s): Communication Studies 
	Corilla Peel - Email: cpeel6b@businessweek.com, Section 6, Major(s): Computer Science 
	Tully Duchasteau - Email: tduchasteauq7@google.nl, Section 6, Major(s): Computer Science , Minor(s): Chemistry 
Group 245:
	Lissy Stedson - Email: lstedsonjs@hao123.com, Section 6, Major(s): Computer Science , Minor(s): Chemistry 
	Therese Stephenson - Email: tstephensonpu@creativecommons.org, Section 6, Major(s): Computer Science , Minor(s): Communication Studies 
	Waylan Williamson - Email: wwilliamsonpn@taobao.com, Section 6, Major(s): Computer Science 
Group 246:
	Hilliard Sarah - Email: hsarahd7@youtube.com, Section 6, Major(s): Computer Science , Minor(s): Chemistry 
	Casie Normington - Email: cnormingtonoz@weebly.com, Section 6, Major(s): Computer Science 
	Natty Mottershead - Email: nmottershead20@macromedia.com, Section 6, Major(s): Computer Science 
Group 247:
	Pamela O'Kuddyhy - Email: pokuddyhyqa@amazon.co.uk, Section 6, Major(s): Computer Science 
	Saxon Robillart - Email: srobillartpj@comcast.net, Section 6, Major(s): Computer Science 
	Ginny Laxon - Email: glaxon81@bluehost.com, Section 6, Major(s): Computer Science 
Group 248:
	Sollie Kopec - Email: skopecqn@indiegogo.com, Section 6, Major(s): Computer Science , Minor(s): Communication Studies 
Group 249:
	Horatia Christmas - Email: hchristmasop@uiuc.edu, Section 12, Major(s): Psychology 
	Olva Dillamore - Email: odillamore86@hugedomains.com, Section 12, Major(s): Health & Exercise Science 
	Ruthi Calloway - Email: rcalloway8c@gov.uk, Section 12, Major(s): Mechanical Engineering 
Group 250:
	Penelope Deval - Email: pdevalmy@usatoday.com, Section 12, Major(s): Sociology 
	Gerianna Damrel - Email: gdamrelf4@statcounter.com, Section 12, Major(s): Computer Science 
	Miner Damiral - Email: mdamiral51@delicious.com, Section 12, Major(s): Political Science 
Group 251:
	Iosep Deeks - Email: ideeksqv@webs.com, Section 12, Major(s): Computer Science 
	Jolee Denzilow - Email: jdenzilow5v@redcross.org, Section 12, Major(s): Physics 
	Ashli De Pietri - Email: adepietrii2@dell.com, Section 12, Major(s): Criminology 
Group 252:
	Zelda Danielczyk - Email: zdanielczykl5@noaa.gov, Section 12, Major(s): Mechanical Engineering 
	Gianna Donohoe - Email: gdonohoeg1@clickbank.net, Section 12, Major(s): Sociology 
	Killy Castillou - Email: kcastilloun3@creativecommons.org, Section 12, Major(s): Computer Science 
Group 253:
	Seumas Callinan - Email: scallinanpw@ibm.com, Section 12, Major(s): Computer Science 
	Alex Colcomb - Email: acolcomb4y@woothemes.com, Section 12, Major(s): Nursing 
	Pearl Downs - Email: pdownsix@mayoclinic.com, Section 12, Major(s): Psychology 
Group 254:
	Randee Deguara - Email: rdeguaralc@bloglovin.com, Section 12, Major(s): Women & Gender Studies 
	Joly Center - Email: jcenterky@phpbb.com, Section 12, Major(s): Computer Science 
	Bentley Custed - Email: bcustedic@technorati.com, Section 12, Major(s): Psychology 
Group 255:
	Cornell Chad - Email: cchad2z@rediff.com, Section 12, Major(s): Finance 
	Regine Ditch - Email: rditchh6@ebay.co.uk, Section 12, Major(s): Psychology 
	Berny Deppen - Email: bdeppen36@mediafire.com, Section 12, Major(s): Mechanical Engineering 
Group 256:
	Felicio Calven - Email: fcalven3o@unc.edu, Section 12, Major(s): Communication Studies 
	Archy Domino - Email: adomino7q@shutterfly.com, Section 12, Major(s): Women & Gender Studies 
	Lula Cohani - Email: lcohani25@hostgator.com, Section 12, Major(s): Health & Exercise Science 
Group 257:
	Kristen Collyer - Email: kcollyerbf@ning.com, Section 12, Major(s): Communication Studies 
	Kimbra Davidou - Email: kdavidouje@patch.com, Section 12, Major(s): Mechanical Engineering 
	Karleen Westgarth - Email: kwestgarthgs@eepurl.com, Section 12, Major(s): Chemistry 
Group 258:
	Hamnet Cord - Email: hcordgw@sakura.ne.jp, Section 12, Major(s): Criminology 
	Bank Dow - Email: bdowoh@webmd.com, Section 12, Major(s): Psychology 
	Woodie Yabsley - Email: wyabsley8y@state.gov, Section 12, Major(s): Electrical Engineering 
Group 259:
	Benjie Dahmke - Email: bdahmkepk@ucsd.edu, Section 12, Major(s): Computer Science 
	Pennie Christoffersen - Email: pchristoffersenb1@icq.com, Section 12, Major(s): Physics 
	Kristina Creighton - Email: kcreightonks@princeton.edu, Section 12, Major(s): Economics 
Group 260:
	Donn Danigel - Email: ddanigel9e@blogspot.com, Section 12, Major(s): Sociology 
	Shari Descroix - Email: sdescroixb6@ask.com, Section 12, Major(s): Women & Gender Studies 
	Shadow Cromar - Email: scromarq6@shareasale.com, Section 12, Major(s): Computer Science 
Group 261:
	Riordan Cleminson - Email: rcleminsonh2@163.com, Section 12, Major(s): Mechanical Engineering 
	Cynthie Cobbled - Email: ccobbled2d@bigcartel.com, Section 12, Major(s): Nursing 
	Mylo Cokayne - Email: mcokayneor@amazonaws.com, Section 12, Major(s): Computer Science 
Group 262:
	Woody Chomley - Email: wchomleypr@hao123.com, Section 12, Major(s): Computer Science 
	Paulo Concklin - Email: pconcklinlr@irs.gov, Section 12, Major(s): Women & Gender Studies 
	Nerty Cleiment - Email: ncleiment2t@msu.edu, Section 12, Major(s): Communication Studies 
Group 263:
	Trista Crum - Email: tcrum5l@tamu.edu, Section 12, Major(s): Health & Exercise Science 
	Karia Curless - Email: kcurless1q@posterous.com, Section 12, Major(s): Economics 
	Row Crossgrove - Email: rcrossgrovekw@cafepress.com, Section 12, Major(s): Communication Studies 
Group 264:
	Penny Coppins - Email: pcoppins3a@nifty.com, Section 12, Major(s): Physics 
	Thorvald Casino - Email: tcasinokd@mysql.com, Section 12, Major(s): Computer Science 
	Concettina Crack - Email: ccrackbu@google.fr, Section 12, Major(s): Nursing 
Group 265:
	Jack De Carteret - Email: jdecarteret1i@cafepress.com, Section 12, Major(s): Nursing 
	Loralee Dingate - Email: ldingate47@shutterfly.com, Section 12, Major(s): Psychology 
	Frankie Darbey - Email: fdarbeymu@sciencedirect.com, Section 12, Major(s): Mechanical Engineering 
Group 266:
	Link Dalgarnowch - Email: ldalgarnowch4l@instagram.com, Section 12, Major(s): Computer Science 
	Carissa Vardey - Email: cvardeyj4@google.co.uk, Section 12, Major(s): Chemistry 
	Baxie Dansey - Email: bdanseyo9@reverbnation.com, Section 12, Major(s): Psychology 
Group 267:
	Thomasin Cesaric - Email: tcesaricjh@altervista.org, Section 12, Major(s): Physics 
Group 268:
	Burnaby Ockland - Email: bocklandrd@uiuc.edu, Section 10, Major(s): Statistics , Minor(s): Psychology 
	Aurie Donan - Email: adonan9i@icq.com, Section 10, Major(s): Accounting , Minor(s): Psychology 
	Gottfried Haldene - Email: ghaldene9g@ycombinator.com, Section 10, Major(s): Women & Gender Studies 
Group 269:
	Maiga Simmers - Email: msimmersl9@aboutads.info, Section 10, Major(s): Psychology , Minor(s): Political Science 
	Dottie Dufaire - Email: ddufairerf@npr.org, Section 10, Major(s): Statistics , Minor(s): Psychology 
	Malvin Essame - Email: messamepe@noaa.gov, Section 10, Major(s): Statistics 
Group 270:
	Sharleen Lax - Email: slaxez@eepurl.com, Section 10, Major(s): Accounting , Minor(s): Psychology 
	Lion Seers - Email: lseers5x@ibm.com, Section 10, Major(s): Psychology , Minor(s): Political Science 
	Berrie Vennings - Email: bvenningslp@123-reg.co.uk, Section 10, Major(s): Sociology , Minor(s): Political Science Philiosophy
Group 271:
	Giralda Cator - Email: gcatorh8@symantec.com, Section 10, Major(s): Statistics , Minor(s): Psychology 
	Nydia Giraudoux - Email: ngiraudoux1s@usda.gov, Section 10, Major(s): African American Studies 
	Eloisa Kime - Email: ekimem7@paypal.com, Section 10, Major(s): Accounting , Minor(s): Psychology 
Group 272:
	Arthur Henken - Email: ahenkenj0@examiner.com, Section 10, Major(s): Women & Gender Studies 
	Kipper Paszak - Email: kpaszakiz@storify.com, Section 10, Major(s): Statistics 
	Carolin Elnor - Email: celnoroy@mit.edu, Section 10, Major(s): Statistics 
Group 273:
	Hermione Upcott - Email: hupcottcg@dailymotion.com, Section 10, Major(s): Finance 
	Chan Hollingshead - Email: chollingsheadk6@photobucket.com, Section 10, Major(s): Women & Gender Studies 
	Hugo Reymers - Email: hreymerseb@goo.gl, Section 10, Major(s): Statistics 
Group 274:
	Tabbatha Unwins - Email: tunwinsji@sina.com.cn, Section 10, Major(s): Psychology , Minor(s): Political Science 
	Arman Spon - Email: asponla@washington.edu, Section 10, Major(s): Sociology , Minor(s): Political Science Philiosophy
	Camala Spacie - Email: cspacie1n@statcounter.com, Section 10, Major(s): Sociology , Minor(s): Political Science Philiosophy
Group 275:
	Berny Sillick - Email: bsillickko@aboutads.info, Section 10, Major(s): Psychology , Minor(s): Political Science 
	Linda Dulieu - Email: ldulieuie@engadget.com, Section 10, Major(s): Statistics , Minor(s): Psychology 
	Emmalynn Greengrass - Email: egreengrassn0@merriam-webster.com, Section 10, Major(s): Women & Gender Studies 
Group 276:
	Haskell Edwick - Email: hedwick8k@livejournal.com, Section 10, Major(s): Statistics 
	Wade Denny - Email: wdennyx@smh.com.au, Section 10, Major(s): African American Studies 
	Romola Wandrey - Email: rwandrey6@wikia.com, Section 10, Major(s): Biomedical Engineering 
Group 277:
	Conney Sulter - Email: csulternc@umn.edu, Section 10, Major(s): Psychology , Minor(s): Political Science 
	Patric Okroy - Email: pokroyri@symantec.com, Section 10, Major(s): Statistics , Minor(s): Psychology 
	Lisle Ormonde - Email: lormonde3e@ebay.com, Section 10, Major(s): Statistics 
Group 278:
	Berti Gabits - Email: bgabits3h@auda.org.au, Section 10, Major(s): Accounting 
	Grata Nazareth - Email: gnazarethkq@bizjournals.com, Section 10, Major(s): Statistics , Minor(s): Psychology 
	Gearalt Pischof - Email: gpischofnr@geocities.com, Section 10, Major(s): Psychology , Minor(s): Political Science 
Group 279:
	Masha Pigot - Email: mpigotp5@jigsy.com, Section 10, Major(s): Psychology , Minor(s): Political Science 
	Arturo Duke - Email: adukemm@odnoklassniki.ru, Section 10, Major(s): Accounting , Minor(s): Psychology 
	Wilhelm Levane - Email: wlevaneee@boston.com, Section 10, Major(s): Accounting , Minor(s): Psychology 
Group 280:
	Bunni Dreinan - Email: bdreinanw@cocolog-nifty.com, Section 10, Major(s): Accounting , Minor(s): Psychology 
	Vachel Pehrsson - Email: vpehrssonby@elegantthemes.com, Section 10, Major(s): Psychology , Minor(s): Political Science 
	Tomi Woodroff - Email: twoodrofflq@upenn.edu, Section 10, Major(s): Statistics 
Group 281:
	Winnifred La Grange - Email: wlagrangekt@sourceforge.net, Section 10, Major(s): Accounting , Minor(s): Psychology 
	Alister Demko - Email: ademkone@youku.com, Section 10, Major(s): Statistics , Minor(s): Psychology 
Group 282:
	Frasco Wheal - Email: fwhealhq@reddit.com, Section 13, Major(s): Physics 
	Gregorio Earengey - Email: gearengeypf@craigslist.org, Section 13, Major(s): Computer Science 
	Siegfried Haill - Email: shaillre@miibeian.gov.cn, Section 13, Major(s): Statistics 
Group 283:
	Deina Gravey - Email: dgraveyn9@gizmodo.com, Section 13, Major(s): Mechanical Engineering 
	Terri Glavis - Email: tglavislb@naver.com, Section 13, Major(s): Statistics 
	Annis Gerlack - Email: agerlackbi@cbsnews.com, Section 13, Major(s): Criminology 
Group 284:
	Frances Fermin - Email: ffermingk@woothemes.com, Section 13, Major(s): Physics 
	Melisande Gellert - Email: mgellertbs@tamu.edu, Section 13, Major(s): Mechanical Engineering 
	Erek Grinyov - Email: egrinyovb9@tinypic.com, Section 13, Major(s): African American Studies 
Group 285:
	Leoline Evill - Email: leville5@soup.io, Section 13, Major(s): Mechanical Engineering 
	Baron Freckleton - Email: bfreckletond9@4shared.com, Section 13, Major(s): Electrical Engineering 
	Basilio Eam - Email: beam8i@tripod.com, Section 13, Major(s): Psychology 
Group 286:
	Sydney Hakey - Email: shakeym0@sciencedirect.com, Section 13, Major(s): Mechanical Engineering 
	Freedman Frean - Email: ffreanoj@alexa.com, Section 13, Major(s): Computer Science 
	Fitz Farren - Email: ffarrenec@arstechnica.com, Section 13, Major(s): Women & Gender Studies 
Group 287:
	Danny Flounders - Email: dflounders60@networkadvertising.org, Section 13, Major(s): Women & Gender Studies 
	Ginnifer Hamnett - Email: ghamnettht@yahoo.co.jp, Section 13, Major(s): Statistics 
	Agatha Footer - Email: afooter15@imdb.com, Section 13, Major(s): Computer Science 
Group 288:
	Noam Grovier - Email: ngrovier7b@amazon.co.uk, Section 13, Major(s): Health & Exercise Science 
	Marilyn Fairnie - Email: mfairnieh7@odnoklassniki.ru, Section 13, Major(s): Sociology 
	Vinni Vasechkin - Email: vvasechkin7n@moonfruit.com, Section 13, Major(s): Psychology 
Group 289:
	Marylin Gooly - Email: mgoolych@webs.com, Section 13, Major(s): Health & Exercise Science 
	Sallyann Durrant - Email: sdurranta7@flickr.com, Section 13, Major(s): Political Science 
	Gottfried Dumbleton - Email: gdumbletonej@newyorker.com, Section 13, Major(s): Computer Science 
Group 290:
	Maxie Grigoli - Email: mgrigoli5i@ucoz.ru, Section 13, Major(s): Electrical Engineering 
	Liana Foxhall - Email: lfoxhallqf@creativecommons.org, Section 13, Major(s): Computer Science 
	Madella Font - Email: mfontj7@ihg.com, Section 13, Major(s): Computer Science 
Group 291:
	Ulla Gissing - Email: ugissingno@acquirethisname.com, Section 13, Major(s): Mechanical Engineering 
	Lorry Garretts - Email: lgarrettsin@deviantart.com, Section 13, Major(s): Criminology 
	Gaven Drayson - Email: gdrayson99@utexas.edu, Section 13, Major(s): Nursing 
Group 292:
	Corey Eadmeades - Email: ceadmeadesiw@usgs.gov, Section 13, Major(s): Physics 
	Sampson Gammidge - Email: sgammidgeok@dyndns.org, Section 13, Major(s): Criminology 
	Dinny Gebbe - Email: dgebbemf@liveinternet.ru, Section 13, Major(s): Mechanical Engineering 
Group 293:
	Risa Haestier - Email: rhaestierq2@umich.edu, Section 13, Major(s): Computer Science 
	Amara Farenden - Email: afarendena8@list-manage.com, Section 13, Major(s): Psychology 
	Filberte Gofford - Email: fgoffordrg@indiegogo.com, Section 13, Major(s): Statistics 
Group 294:
	Angelia Falconer - Email: afalconerqp@abc.net.au, Section 13, Major(s): Computer Science 
	Kayla Yanshin - Email: kyanshinjk@nymag.com, Section 13, Major(s): Statistics 
	Milissent Drake - Email: mdrake7h@ovh.net, Section 13, Major(s): Mechanical Engineering 
Group 295:
	Julia Freiburger - Email: jfreiburgerob@nydailynews.com, Section 13, Major(s): Computer Science 
	Doretta Hanhard - Email: dhanharddc@chronoengine.com, Section 13, Major(s): Health & Exercise Science 
	Benjy Dumbleton - Email: bdumbletono4@state.gov, Section 13, Major(s): Criminology 
Group 296:
	Mimi Dunkersley - Email: mdunkersleyqo@ustream.tv, Section 13, Major(s): Computer Science 
	Isac Ericsson - Email: iericssoncp@zdnet.com, Section 13, Major(s): Nursing 
	Reeba Elsom - Email: relsomeu@yellowbook.com, Section 13, Major(s): Psychology 
Group 297:
	Beaufort Hablot - Email: bhablot78@timesonline.co.uk, Section 13, Major(s): Electrical Engineering 
	Justin Guillou - Email: jguilloupz@about.com, Section 13, Major(s): Computer Science 
	Terrie Gethouse - Email: tgethouseqg@paypal.com, Section 13, Major(s): Computer Science 
Group 298:
	Chick Hamm - Email: chammqu@forbes.com, Section 13, Major(s): Computer Science 
	Jolyn Gorwood - Email: jgorwoodg4@cnet.com, Section 13, Major(s): Economics 
	Philippine Draper - Email: pdraperr@mashable.com, Section 13, Major(s): Psychology 
Group 299:
	Ede Greswell - Email: egreswellqd@xing.com, Section 13, Major(s): Computer Science 
	Seymour Duffell - Email: sduffell3d@miibeian.gov.cn, Section 13, Major(s): Sociology 
	Lorry Hankard - Email: lhankardb5@java.com, Section 13, Major(s): Statistics 
Group 300:
	Fayette Gerssam - Email: fgerssam6s@ask.com, Section 13, Major(s): Psychology 
	Nolie Gailor - Email: ngailor3q@simplemachines.org, Section 13, Major(s): Computer Science 
	Alexandre Flucks - Email: afluckskk@amazon.co.jp, Section 13, Major(s): Mechanical Engineering 
Group 301:
	Agace Gage - Email: agageqr@sun.com, Section 13, Major(s): Computer Science 
	Reena Flintoft - Email: rflintoftit@godaddy.com, Section 13, Major(s): Mechanical Engineering 
	Thorpe Grason - Email: tgrasongl@dot.gov, Section 13, Major(s): Psychology 
Group 302:
	Rory Irnis - Email: rirnislo@marriott.com, Section 14, Major(s): Psychology 
	Imogene Holehouse - Email: iholehousek@twitpic.com, Section 14, Major(s): Mathematics 
	Rochester Horrod - Email: rhorrod6j@topsy.com, Section 14, Major(s): Interdisciplinary Studies 
Group 303:
	Galven Hildrew - Email: ghildrew2h@accuweather.com, Section 14, Major(s): Psychology 
	Spike Kaiser - Email: skaisernm@theguardian.com, Section 14, Major(s): Journalism 
	Corny Kingswoode - Email: ckingswoode5q@amazonaws.com, Section 14, Major(s): Mathematics 
Group 304:
	Robby Lewson - Email: rlewsonpb@behance.net, Section 14, Major(s): Journalism 
	Elvera Kneafsey - Email: ekneafsey1m@indiatimes.com, Section 14, Major(s): Psychology 
	Eddy Whipp - Email: ewhippfs@ucoz.com, Section 14, Major(s): Finance 
Group 305:
	Brod Klosser - Email: bklosser1k@linkedin.com, Section 14, Major(s): Physics 
	Corella Lightbourn - Email: clightbourn2b@squidoo.com, Section 14, Major(s): Mechanical Engineering 
	Bartlet Hillburn - Email: bhillburnea@blogs.com, Section 14, Major(s): Sociology 
Group 306:
	Tito Hylden - Email: thyldenn@tamu.edu, Section 14, Major(s): Nursing 
	Marcille Lear - Email: mleardo@edublogs.org, Section 14, Major(s): Psychology 
	L;urette Honsch - Email: lhonschkr@nymag.com, Section 14, Major(s): Women & Gender Studies 
Group 307:
	Meridel Hovenden - Email: mhovendenkp@apache.org, Section 14, Major(s): Sociology 
	Victor Kloisner - Email: vkloisneri0@jugem.jp, Section 14, Major(s): Computer Engineering 
	Tara House - Email: thouse9d@chron.com, Section 14, Major(s): Psychology 
Group 308:
	Janean Izzat - Email: jizzatll@nymag.com, Section 14, Major(s): Mechanical Engineering 
	Martino Isley - Email: misley5y@cnn.com, Section 14, Major(s): Sociology 
	Lock Kealy - Email: lkealy8e@gizmodo.com, Section 14, Major(s): Nursing 
Group 309:
	Sherlock Hindenberger - Email: shindenbergerfa@ucoz.ru, Section 14, Major(s): Mathematics 
	Anni Huckabe - Email: ahuckabenv@aol.com, Section 14, Major(s): Computer Science 
	Debbi Lamprecht - Email: dlamprechtem@is.gd, Section 14, Major(s): Finance 
Group 310:
	Nancy Lapre - Email: nlapre6f@cocolog-nifty.com, Section 14, Major(s): Finance 
	Baldwin Jaggard - Email: bjaggardpl@utexas.edu, Section 14, Major(s): Computer Science 
	Danni Jakubovits - Email: djakubovits6o@digg.com, Section 14, Major(s): Nursing 
Group 311:
	Ema Kingsnode - Email: ekingsnodejy@europa.eu, Section 14, Major(s): Mathematics 
	Amalee Joris - Email: ajoriscu@cafepress.com, Section 14, Major(s): Sociology 
	Cornie Liddon - Email: cliddong0@a8.net, Section 14, Major(s): Psychology 
Group 312:
	Odette Kenealy - Email: okenealydi@salon.com, Section 14, Major(s): Mechanical Engineering 
	Sheri Kissack - Email: skissackdh@free.fr, Section 14, Major(s): Mathematics 
	Clay Jakubczyk - Email: cjakubczykgd@buzzfeed.com, Section 14, Major(s): Finance 
Group 313:
	Diana Livingstone - Email: dlivingstone9t@cnn.com, Section 14, Major(s): Electrical Engineering 
	Stormie Lettsom - Email: slettsomjv@mit.edu, Section 14, Major(s): Finance 
	Stephie Itzcovich - Email: sitzcovichid@friendfeed.com, Section 14, Major(s): Sociology 
Group 314:
	Leland Lippitt - Email: llippitth5@gizmodo.com, Section 14, Major(s): Physics 
	Gradey Kimbury - Email: gkimburyl3@ning.com, Section 14, Major(s): Journalism 
	Elna Lavens - Email: elavens8j@blogspot.com, Section 14, Major(s): Sociology 
Group 315:
	Gwynne Hanrott - Email: ghanrottfp@amazon.co.jp, Section 14, Major(s): Computer Science 
	Selene Kibblewhite - Email: skibblewhite5k@washingtonpost.com, Section 14, Major(s): Finance 
	Shandeigh Hinkes - Email: shinkes53@china.com.cn, Section 14, Major(s): Sociology 
Group 316:
	Zonnya Lodewick - Email: zlodewick3y@ebay.com, Section 14, Major(s): Interdisciplinary Studies 
	Berget Lenthall - Email: blenthall8a@marketwatch.com, Section 14, Major(s): Journalism 
	Skipper Harper - Email: sharperbz@sbwire.com, Section 14, Major(s): Sociology 
Group 317:
	Tate Honeywood - Email: thoneywood6v@archive.org, Section 14, Major(s): Women & Gender Studies 
	Berti Jozefiak - Email: bjozefiakb7@de.vu, Section 14, Major(s): Economics 
	Davita Jaumet - Email: djaumet3c@oracle.com, Section 14, Major(s): Psychology 
Group 318:
	Lurette Kelledy - Email: lkelledyo3@tuttocitta.it, Section 14, Major(s): Computer Science 
	Lauryn Hilhouse - Email: lhilhousea9@unesco.org, Section 14, Major(s): Sociology 
	Lavina Hedling - Email: lhedlinggh@deviantart.com, Section 14, Major(s): Mechanical Engineering 
Group 319:
	Nalani Hollingsby - Email: nhollingsbyl4@wisc.edu, Section 14, Major(s): Mathematics 
	Dannie Innwood - Email: dinnwoodpm@netscape.com, Section 14, Major(s): Computer Science 
	Erny Kolodziejski - Email: ekolodziejskipq@hexun.com, Section 14, Major(s): Computer Science 
Group 320:
	Sapphira Yoxen - Email: syoxenph@51.la, Section 14, Major(s): Computer Science 
	Margeaux Ventum - Email: mventumiy@liveinternet.ru, Section 14, Major(s): Sociology 
	Myrna Klus - Email: mklusip@state.tx.us, Section 14, Major(s): Finance 
Group 321:
	Ulysses Livard - Email: ulivardkz@usatoday.com, Section 14, Major(s): Criminology 
	Elspeth Livard - Email: elivardr1@prlog.org, Section 14, Major(s): Journalism 
Group 322:
	Maribeth Matkovic - Email: mmatkovic41@hatena.ne.jp, Section 15, Major(s): Mechanical Engineering 
	Bondy Noteyoung - Email: bnoteyoungms@china.com.cn, Section 15, Major(s): Journalism 
	Estele Lubman - Email: elubmane3@macromedia.com, Section 15, Major(s): Journalism 
Group 323:
	Kellie Matteau - Email: kmatteaucc@creativecommons.org, Section 15, Major(s): Computer Science 
	Samara Loveard - Email: sloveardof@alibaba.com, Section 15, Major(s): Journalism 
	Haskell Maylam - Email: hmaylamao@dot.gov, Section 15, Major(s): Electrical Engineering 
Group 324:
	Drud Whitwam - Email: dwhitwamqs@sbwire.com, Section 15, Major(s): Computer Science 
	Neila Mishow - Email: nmishowma@flavors.me, Section 15, Major(s): Criminology 
	Pail Marusik - Email: pmarusikab@mashable.com, Section 15, Major(s): Women & Gender Studies 
Group 325:
	Wildon Lorimer - Email: wlorimerbl@omniture.com, Section 15, Major(s): Finance 
	Darrick McAlees - Email: dmcalees7o@amazonaws.com, Section 15, Major(s): Sociology 
	Torie Morrill - Email: tmorrill1a@livejournal.com, Section 15, Major(s): Health & Exercise Science 
Group 326:
	Inger McColm - Email: imccolm16@hhs.gov, Section 15, Major(s): Criminology 
	Andrei Nalder - Email: analderij@wiley.com, Section 15, Major(s): Chemistry 
	Tersina McGurn - Email: tmcgurn5g@huffingtonpost.com, Section 15, Major(s): Computer Science 
Group 327:
	Fonz Mattussevich - Email: fmattussevichfk@paginegialle.it, Section 15, Major(s): Accounting 
	Padraig McFarland - Email: pmcfarlandh1@chicagotribune.com, Section 15, Major(s): Mathematics 
	Clive Meineking - Email: cmeinekingbx@posterous.com, Section 15, Major(s): Political Science 
Group 328:
	Trenton Margerrison - Email: tmargerrison2w@nature.com, Section 15, Major(s): Criminology 
	Somerset McCumesky - Email: smccumeskyih@wikia.com, Section 15, Major(s): Accounting 
	Neely McKillop - Email: nmckillop9w@dailymotion.com, Section 15, Major(s): Health & Exercise Science 
Group 329:
	Artur MacAndreis - Email: amacandreisqq@dell.com, Section 15, Major(s): Computer Science 
	Cad Matz - Email: cmatzja@indiegogo.com, Section 15, Major(s): Finance 
	Rani Madeley - Email: rmadeleya2@unblog.fr, Section 15, Major(s): Mechanical Engineering 
Group 330:
	Alford Macro - Email: amacron8@un.org, Section 15, Major(s): Mathematics 
	Luise Maior - Email: lmaiorcr@forbes.com, Section 15, Major(s): Physics 
	Dione Medlicott - Email: dmedlicottg5@sciencedaily.com, Section 15, Major(s): Accounting 
Group 331:
	Wolfie Milbourne - Email: wmilbournedp@google.com, Section 15, Major(s): Sociology 
	Hermione Meates - Email: hmeateslk@deviantart.com, Section 15, Major(s): Mathematics 
	Jasen Mates - Email: jmatesbp@cnn.com, Section 15, Major(s): Interdisciplinary Studies 
Group 332:
	Gabbie McGuire - Email: gmcguire8g@stumbleupon.com, Section 15, Major(s): Physics 
	Matty Yukhnini - Email: myukhninim4@dropbox.com, Section 15, Major(s): Sociology 
	Bernadene Lowbridge - Email: blowbridgeo7@disqus.com, Section 15, Major(s): Journalism 
Group 333:
	Egbert Meaney - Email: emeaneye4@imdb.com, Section 15, Major(s): Mathematics 
	Tomasine Megarrell - Email: tmegarrell1@vistaprint.com, Section 15, Major(s): Accounting 
	Sherye Niche - Email: sniche58@photobucket.com, Section 15, Major(s): African American Studies 
Group 334:
	Heriberto Oakley - Email: hoakley6t@instagram.com, Section 15, Major(s): Sociology 
	Timotheus Moynham - Email: tmoynham38@cam.ac.uk, Section 15, Major(s): Nursing 
	Tuesday Mower - Email: tmower80@1688.com, Section 15, Major(s): Computer Engineering 
Group 335:
	Nerita McLauchlin - Email: nmclauchlin4n@cbc.ca, Section 15, Major(s): Electrical Engineering 
	Chance Lorenzin - Email: clorenzin1z@guardian.co.uk, Section 15, Major(s): Computer Engineering 
	Beryle Marcussen - Email: bmarcussenr7@shareasale.com, Section 15, Major(s): Journalism 
Group 336:
	Alysa MacGahey - Email: amacgaheya6@cdbaby.com, Section 15, Major(s): Physics 
	Willem Verny - Email: wverny12@vinaora.com, Section 15, Major(s): Chemistry 
	Wells MacFayden - Email: wmacfayden4p@google.it, Section 15, Major(s): Finance 
Group 337:
	Willie Mitcheson - Email: wmitcheson22@angelfire.com, Section 15, Major(s): Electrical Engineering 
	Ogden Nolton - Email: onoltonet@theglobeandmail.com, Section 15, Major(s): Physics 
	Lemar Mitie - Email: lmitienj@google.fr, Section 15, Major(s): Criminology 
Group 338:
	Gerome Menendes - Email: gmenendes48@blogtalkradio.com, Section 15, Major(s): Sociology 
	Elwyn Murrock - Email: emurrockb@cpanel.net, Section 15, Major(s): Criminology 
	Jarrad Mooney - Email: jmooneyl1@twitter.com, Section 15, Major(s): Finance 
Group 339:
	Gianina McKitterick - Email: gmckitterick3i@twitpic.com, Section 15, Major(s): African American Studies 
	Walther McRobbie - Email: wmcrobbiefz@accuweather.com, Section 15, Major(s): Physics 
	Auberon Lodwig - Email: alodwig6m@bloomberg.com, Section 15, Major(s): Mechanical Engineering 
